Wo, Wo, Ww, Ww, Ai, Ms, Ms, Ms, Ql, Ql, Ql, Ql, Ql, Ql, Mm, Mm, Mm, Mm, Mm, Mm, Mm, Mm
Ww, Ww, Ai, Ai, Mm, Ms, Ms, Ms, Ha, Ql, Ql, Ql, Ql, Mm, Mm, Mm, Mm, Mm, Mm, Mm, Mm, Mm
Ai, Ai, Mm, Mm, Ms, Ms, Ha, Ha, Aa, Uh, Mv, Ql, Hh, Hh, Hh, Mm, Mm, Mm, Mm, Mm, Mm, Mm
Ms, Mm, Ms, Ms, Ha, Ha, Aa, Aa, Aa, Uh, Uh, Uh, Gs^Fp, Hh, Hh, Hh, Hh, Mm, Mm, Mm, Mm, Mm
Ms, Ms, Ha, Ha, Aa, Aa, Aa^Fpa, Aa^Fda, Aa, Uu^Emf, Volcano Uu, Uu^Uf, Gs^Fp, Gs^Fp, Gs^Fp, Hh, Hh, Hh, Hh, Mm, Mm, Mm
Ha, Ha, Aa, Aa, Aa^Fpa, Aa^Fpa, Aa^Fpa, Aa^Fpa, Aa, Uu^Emf, Ur, Uu^Uf, Gs^Fp, Gs^Fp, Gs^Fp, Gs^Fp, Gs^Fp, Hh, Hh, Hh, Hh, Mm
Aa, Aa, Aa^Fda, Aa^Fda, Aa^Fpa, Aa^Fpa, Aa^Fpa, Aa^Fpa, Aa, Uu, Cave Uu^Vu, Uu, Gs^Fp, Gs^Fp, Gs^Fp, Gs^Fp, Gs^Fp, Gs^Fp, Gs^Fp, Hh, Hh, Hh
Aa^Fda, Aa^Fda, Aa^Fpa, Aa^Fpa, Aa^Fpa, Aa^Fpa, Aa^Fpa, Aa^Fpa, Aa, Uu, Ur, Uu, Gs^Fp, Gs^Fp, Gs^Fp, Gs^Fp, Gs^Fp, Gs^Fp, Gs^Fp, Gs^Fp, Gs^Fp, Hh
Aa, Aa^Fda, Aa^Fpa, Aa^Fpa, Aa^Fpa, Aa^Fpa, Winter Aa^Vha, Aa^Fpa, Aa, Uu, Ur, Uu, Gs, Gs^Fp, Plain Gs^Ve, Gs^Fp, Gs^Fp, Gs^Fp, Gs^Fp, Gs^Fp, Gs^Fp, Gs^Fp
Aa, Aa, Aa, Aa, Aa, Aa, Aa, Re, Re, Gg, Rrc, Gg, Rr, Rr, Gs^Fp, Gs^Fp, Gs^Fp, Gs^Fp, Gs^Fp, Gs^Fp, Gs^Fp, Gs^Fp
Gg, Gg, Gg, Gg, Gg, Gg, Gg, Gg, Rp, Ch, 1 Kh, Ch, Rp, Gg, Gg, Gg, Gg, Gg, Gg, Gg, Gg, Gg
Ss, Gg, Ss, Gg, Ss, Gg, Ss, Gg, Rb, Ch, Rp, Ch, Rd, Gg, Dd, Gg, Dd, Gg, Dd, Gg, Ds, Gg
Ss, Ss, Gs^Ft, Ss, Ss, Ss, Marsh Ss^Vhs, Rb, WCII Gg, Gg, Gg, Gg, Sigurd Gg, Rd, Desert Dd^Vda, Dd, Dd^Ftd, Dd, Dd, Dd, Dd, Ds
Ss, Ss, Gs^Ft, Gs^Ft, Ss, Ss, Ss, Rb, Gg, Gg, Well Gg, Gg, Gg, Rd, Dd^Ftd, Dd^Ftd, Dd^Ftd, Dd^Ftd, Dd, Dd^Dc, Dd, Dd
Ss, Ss, Ss, Ss, Ss, Ss, Ss, Ss, Ss, Gg, Gg, Gg, Dd^Ftd, Dd^Ftd, Dd^Ftd, Dd^Do, Dd, Dd, Dd, Dd, Hd, Hd
Ss, Ss, Ss, Ss, Gs^Ft, Gs^Ft, Gs^Ft, Gs^Ft, Ss, Gs^Ftp, Gs^Ftp, Gs^Ftp, Dd, Dd^Ftd, Dd, Dd^Dc, Hd, Hd, Hd, Hd, Hd, Hd
Ss, Ss, Sm, Ss, Ss, Ss, Ss, Ss, Ss, Gs^Ftp, Gs^Ftp, Gs^Ftp, Dd, Dd, Dd, Dd, Hd, Hd, Hd, Hd, Hd, Hd
Wwg, Chs, Sm, Sm, Sm, Ss, Ss, Ss, Ss, Gs^Ftp, Gs^Ftp, Gs^Ftp, Dd, Dd, Hd, Hd, Hd, Hd, Hd, Hd, Hd, Mdd
Wwg, Wwg^Bw|r, Wwg, Sm, Sm, Sm, Ss, Ss, Ss, Gs^Ftp, Gs^Ftp, Gs^Ftp, Dd, Dd, Hd, Hd, Hd, Hd, Mdd, Mdd, Mdd, Mdd
Wog, Wwg^Bw\r, Wwg^Bw\r, Wwg, Wwg^Bw/r, Chs, Wwg, Ss, Ss, Gs^Ftp, Gs^Ftp, Gs^Ftp, Dd, Dd, Hd, Hd, Hd, Mdd, Mdd, Mdd, Mdd, Mdd
Wog, Wog, Wog, Wwg^Bw/r, Wwg, Wwg, Wwg, Wwg, Ss, Gs^Ftp, Gs^Ftp, Gs^Ftp, Dd, Dd, Hd, Mdd, Mdd, Mdd, Mdd, Mdd, Mdd, Mdd
Wog, Wog, Wog, Wog, Wog, Wwg, Sm, Wwg, Wwg, Gs^Ftp, Gs^Ftp, Gs^Ftp, Hd, Dd, Gg, Mdd, Gg, Mdd, Mdd, Mdd, Mdd, Mdd
