Xu, Xu, Xu, Xu, Xu, Xu, Xu, Xu, Xu, Xu, Xu, Xu, Xu, Xu, Xu, Xu, Xu, Xu, Xu, Xu, Xu, Xu, Xu, Xu, Xu, Xu, Xu, Xu, Xu, Xu, Xu, Xu, Xu, Xu, Xu, Xu, Xu, Xu, Xu, Xu, Xu, Xu, Xu, Xu, Xu, Xu, Xu, Xu, Xu, Xu, Xu, Xu
Xu, Aa, Aa, Aa, Aa, Aa, Aa, Aa, Aa, Aa, Xu, Ai, Ai, Ai, Ai, Ai, Ai, Ai, Ai, Ai, Xu, Rrc, Rrc, Rrc, Rrc, Rrc, Rrc, Rrc, Rrc, Rrc, Xu, Ai, Ai, Ai, Ai, Ai, Ai, Ai, Ai, Ai, Xu, Aa, Aa, Aa, Aa, Aa, Aa, Aa, Aa, Aa, Xu, Xu
Xu, Aa, Aa, Aa, Aa, Aa, Aa, Aa, Aa, Aa, Xu, Ai, Ai, Ai, Ai, Ai, Ai, Ai, Ai, Ai, Xu, Rrc, Rrc, Rrc, Rrc, Rrc, Rrc, Rrc, Rrc, Rrc, Xu, Ai, Ai, Ai, Ai, Ai, Ai, Ai, Ai, Ai, Xu, Aa, Aa, Aa, Aa, Aa, Aa, Aa, Aa, Aa, Xu, Xu
Xu, Aa, Aa, Aa, Aa, Aa, Aa, Aa, Aa, Aa, Xu, Ai, Ai, Ai, Ai, Ai, Ai, Ai, Ai, Ai, Xu, Rrc, Rrc, Rrc, Rrc, Rrc, Rrc, Rrc, Rrc, Rrc, Xu, Ai, Ai, Ai, Ai, Ai, Ai, Ai, Ai, Ai, Xu, Aa, Aa, Aa, Aa, Aa, Aa, Aa, Aa, Aa, Xu, Xu
Xu, Aa, Aa, Aa, Cud, Cud, Cud, Aa, Aa, Aa, Xu, Ai, Ai, Ai, Cud, Cud, Cud, Ai, Ai, Ai, Xu, Rrc, Rrc, Rrc, Cud, Cud, Cud, Rrc, Rrc, Rrc, Xu, Ai, Ai, Ai, Cud, Cud, Cud, Ai, Ai, Ai, Xu, Aa, Aa, Aa, Cud, Cud, Cud, Aa, Aa, Aa, Xu, Xu
Xu, Aa, Aa, Aa, Cud, Kud, Cud, Aa, Aa, Aa, Xu, Ai, Ai, Ai, Cud, Kud, Cud, Ai, Ai, Ai, Xu, Rrc, Rrc, Rrc, Cud, Kud, Cud, Rrc, Rrc, Rrc, Xu, Ai, Ai, Ai, Cud, Kud, Cud, Ai, Ai, Ai, Xu, Aa, Aa, Aa, Cud, Kud, Cud, Aa, Aa, Aa, Xu, Xu
Xu, Aa, Aa, Aa, Aa, Cud, Aa, Aa, Aa, Aa, Xu, Ai, Ai, Ai, Ai, Cud, Ai, Ai, Ai, Ai, Xu, Rrc, Rrc, Rrc, Rrc, Cud, Rrc, Rrc, Rrc, Rrc, Xu, Ai, Ai, Ai, Ai, Cud, Ai, Ai, Ai, Ai, Xu, Aa, Aa, Aa, Aa, Cud, Aa, Aa, Aa, Aa, Xu, Xu
Xu, Aa, Aa, Aa, Aa, Aa, Aa, Aa, Aa, Aa, Xu, Ai, Ai, Ai, Ai, Ai, Ai, Ai, Ai, Ai, Xu, Rrc, Rrc, Rrc, Rrc, Rrc, Rrc, Rrc, Rrc, Rrc, Xu, Ai, Ai, Ai, Ai, Ai, Ai, Ai, Ai, Ai, Xu, Aa, Aa, Aa, Aa, Aa, Aa, Aa, Aa, Aa, Xu, Xu
Xu, Aa, Aa, Aa, Aa, Aa, Aa, Aa, Aa, Aa, Xu, Ai, Ai, Ai, Ai, Ai, Ai, Ai, Ai, Ai, Xu, Rrc, Rrc, Rrc, Rrc, Rrc, Rrc, Rrc, Rrc, Rrc, Xu, Ai, Ai, Ai, Ai, Ai, Ai, Ai, Ai, Ai, Xu, Aa, Aa, Aa, Aa, Aa, Aa, Aa, Aa, Aa, Xu, Xu
Xu, Aa, Xu, Aa, Xu, Aa, Xu, Aa, Xu, Aa, Xu, Ai, Xu, Ai, Xu, Ai, Xu, Ai, Xu, Ai, Xu, Rrc, Xu, Rrc, Xu, Rrc, Xu, Rrc, Xu, Rrc, Xu, Ai, Xu, Ai, Xu, Ai, Xu, Ai, Xu, Ai, Xu, Aa, Xu, Aa, Xu, Aa, Xu, Aa, Xu, Aa, Xu, Xu
Xu, Xu, Xu, Xu, Xu, Xu, Xu, Xu, Xu, Xu, Xu, Xu, Xu, Xu, Xu, Xu, Xu, Xu, Xu, Xu, Xu, Xu, Xu, Xu, Xu, Xu, Xu, Xu, Xu, Xu, Xu, Xu, Xu, Xu, Xu, Xu, Xu, Xu, Xu, Xu, Xu, Xu, Xu, Xu, Xu, Xu, Xu, Xu, Xu, Xu, Xu, Xu
Xu, Ai, Ai, Ai, Ai, Ai, Ai, Ai, Ai, Ai, Xu, Ai, Ai, Ai, Ai, Ai, Ai, Ai, Ai, Ai, Xu, Ai, Ai, Ai, Ai, Ai, Ai, Ai, Ai, Ai, Xu, Ai, Ai, Ai, Ai, Ai, Ai, Ai, Ai, Ai, Xu, Ai, Ai, Ai, Ai, Ai, Ai, Ai, Ai, Ai, Xu, Xu
Xu, Ai, Ai, Ai, Ai, Ai, Ai, Ai, Ai, Ai, Xu, Ai, Ai, Ai, Ai, Ai, Ai, Ai, Ai, Ai, Xu, Ai, Ai, Ai, Ai, Ai, Ai, Ai, Ai, Ai, Xu, Ai, Ai, Ai, Ai, Ai, Ai, Ai, Ai, Ai, Xu, Ai, Ai, Ai, Ai, Ai, Ai, Ai, Ai, Ai, Xu, Xu
Xu, Ai, Ai, Ai, Ai, Ai, Ai, Ai, Ai, Ai, Xu, Ai, Ai, Ai, Ai, Ai, Ai, Ai, Ai, Ai, Xu, Ai, Ai, Ai, Ai, Ai, Ai, Ai, Ai, Ai, Xu, Ai, Ai, Ai, Ai, Ai, Ai, Ai, Ai, Ai, Xu, Ai, Ai, Ai, Ai, Ai, Ai, Ai, Ai, Ai, Xu, Xu
Xu, Ai, Ai, Ai, Cud, Cud, Cud, Ai, Ai, Ai, Xu, Ai, Ai, Ai, Cud, Cud, Cud, Ai, Ai, Ai, Xu, Ai, Ai, Ai, Cud, Cud, Cud, Ai, Ai, Ai, Xu, Ai, Ai, Ai, Cud, Cud, Cud, Ai, Ai, Ai, Xu, Ai, Ai, Ai, Cud, Cud, Cud, Ai, Ai, Ai, Xu, Xu
Xu, Ai, Ai, Ai, Cud, Kud, Cud, Ai, Ai, Ai, Xu, Ai, Ai, Ai, Cud, Kud, Cud, Ai, Ai, Ai, Xu, Ai, Ai, Ai, Cud, Kud, Cud, Ai, Ai, Ai, Xu, Ai, Ai, Ai, Cud, Kud, Cud, Ai, Ai, Ai, Xu, Ai, Ai, Ai, Cud, Kud, Cud, Ai, Ai, Ai, Xu, Xu
Xu, Ai, Ai, Ai, Ai, Cud, Ai, Ai, Ai, Ai, Xu, Ai, Ai, Ai, Ai, Cud, Ai, Ai, Ai, Ai, Xu, Ai, Ai, Ai, Ai, Cud, Ai, Ai, Ai, Ai, Xu, Ai, Ai, Ai, Ai, Cud, Ai, Ai, Ai, Ai, Xu, Ai, Ai, Ai, Ai, Cud, Ai, Ai, Ai, Ai, Xu, Xu
Xu, Ai, Ai, Ai, Ai, Ai, Ai, Ai, Ai, Ai, Xu, Ai, Ai, Ai, Ai, Ai, Ai, Ai, Ai, Ai, Xu, Ai, Ai, Ai, Ai, Ai, Ai, Ai, Ai, Ai, Xu, Ai, Ai, Ai, Ai, Ai, Ai, Ai, Ai, Ai, Xu, Ai, Ai, Ai, Ai, Ai, Ai, Ai, Ai, Ai, Xu, Xu
Xu, Ai, Ai, Ai, Ai, Ai, Ai, Ai, Ai, Ai, Xu, Ai, Ai, Ai, Ai, Ai, Ai, Ai, Ai, Ai, Xu, Ai, Ai, Ai, Ai, Ai, Ai, Ai, Ai, Ai, Xu, Ai, Ai, Ai, Ai, Ai, Ai, Ai, Ai, Ai, Xu, Ai, Ai, Ai, Ai, Ai, Ai, Ai, Ai, Ai, Xu, Xu
Xu, Ai, Xu, Ai, Xu, Ai, Xu, Ai, Xu, Ai, Xu, Ai, Xu, Ai, Xu, Ai, Xu, Ai, Xu, Ai, Xu, Ai, Xu, Ai, Xu, Ai, Xu, Ai, Xu, Ai, Xu, Ai, Xu, Ai, Xu, Ai, Xu, Ai, Xu, Ai, Xu, Ai, Xu, Ai, Xu, Ai, Xu, Ai, Xu, Ai, Xu, Xu
Xu, Xu, Xu, Xu, Xu, Xu, Xu, Xu, Xu, Xu, Xu, Xu, Xu, Xu, Xu, Xu, Xu, Xu, Xu, Xu, Xu, Xu, Xu, Xu, Xu, Xu, Xu, Xu, Xu, Xu, Xu, Xu, Xu, Xu, Xu, Xu, Xu, Xu, Xu, Xu, Xu, Xu, Xu, Xu, Xu, Xu, Xu, Xu, Xu, Xu, Xu, Xu
Xu, Rrc, Rrc, Rrc, Rrc, Rrc, Rrc, Rrc, Rrc, Rrc, Xu, Ai, Ai, Ai, Ai, Ai, Ai, Ai, Ai, Ai, Xu, Rp, Rp, Rp, Rp, Rp, Rp, Rp, Rp, Rp, Xu, Ai, Ai, Ai, Ai, Ai, Ai, Ai, Ai, Ai, Xu, Rrc, Rrc, Rrc, Rrc, Rrc, Rrc, Rrc, Rrc, Rrc, Xu, Xu
Xu, Rrc, Rrc, Rrc, Rrc, Rrc, Rrc, Rrc, Rrc, Rrc, Xu, Ai, Ai, Ai, Ai, Ai, Ai, Ai, Ai, Ai, Xu, Rp, Rp, Rp, Rp, Rp, Rp, Rp, Rp, Rp, Xu, Ai, Ai, Ai, Ai, Ai, Ai, Ai, Ai, Ai, Xu, Rrc, Rrc, Rrc, Rrc, Rrc, Rrc, Rrc, Rrc, Rrc, Xu, Xu
Xu, Rrc, Rrc, Rrc, Rrc, Rrc, Rrc, Rrc, Rrc, Rrc, Xu, Ai, Ai, Ai, Ai, Ai, Ai, Ai, Ai, Ai, Xu, Rp, Rp, Rp, Rp, Rp, Rp, Rp, Rp, Rp, Xu, Ai, Ai, Ai, Ai, Ai, Ai, Ai, Ai, Ai, Xu, Rrc, Rrc, Rrc, Rrc, Rrc, Rrc, Rrc, Rrc, Rrc, Xu, Xu
Xu, Rrc, Rrc, Rrc, Cud, Cud, Cud, Rrc, Rrc, Rrc, Xu, Ai, Ai, Ai, Cud, Cud, Cud, Ai, Ai, Ai, Xu, Rp, Rp, Rp, Cud, Cud, Cud, Rp, Rp, Rp, Xu, Ai, Ai, Ai, Cud, Cud, Cud, Ai, Ai, Ai, Xu, Rrc, Rrc, Rrc, Cud, Cud, Cud, Rrc, Rrc, Rrc, Xu, Xu
Xu, Rrc, Rrc, Rrc, Cud, Kud, Cud, Rrc, Rrc, Rrc, Xu, Ai, Ai, Ai, Cud, Kud, Cud, Ai, Ai, Ai, Xu, Rp, Rp, Rp, Cud, Kud, Cud, Rp, Rp, Rp, Xu, Ai, Ai, Ai, Cud, Kud, Cud, Ai, Ai, Ai, Xu, Rrc, Rrc, Rrc, Cud, Kud, Cud, Rrc, Rrc, Rrc, Xu, Xu
Xu, Rrc, Rrc, Rrc, Rrc, Cud, Rrc, Rrc, Rrc, Rrc, Xu, Ai, Ai, Ai, Ai, Cud, Ai, Ai, Ai, Ai, Xu, Rp, Rp, Rp, Rp, Cud, Rp, Rp, Rp, Rp, Xu, Ai, Ai, Ai, Ai, Cud, Ai, Ai, Ai, Ai, Xu, Rrc, Rrc, Rrc, Rrc, Cud, Rrc, Rrc, Rrc, Rrc, Xu, Xu
Xu, Rrc, Rrc, Rrc, Rrc, Rrc, Rrc, Rrc, Rrc, Rrc, Xu, Ai, Ai, Ai, Ai, Ai, Ai, Ai, Ai, Ai, Xu, Rp, Rp, Rp, Rp, Rp, Rp, Rp, Rp, Rp, Xu, Ai, Ai, Ai, Ai, Ai, Ai, Ai, Ai, Ai, Xu, Rrc, Rrc, Rrc, Rrc, Rrc, Rrc, Rrc, Rrc, Rrc, Xu, Xu
Xu, Rrc, Rrc, Rrc, Rrc, Rrc, Rrc, Rrc, Rrc, Rrc, Xu, Ai, Ai, Ai, Ai, Ai, Ai, Ai, Ai, Ai, Xu, Rp, Rp, Rp, Rp, Rp, Rp, Rp, Rp, Rp, Xu, Ai, Ai, Ai, Ai, Ai, Ai, Ai, Ai, Ai, Xu, Rrc, Rrc, Rrc, Rrc, Rrc, Rrc, Rrc, Rrc, Rrc, Xu, Xu
Xu, Rrc, Xu, Rrc, Xu, Rrc, Xu, Rrc, Xu, Rrc, Xu, Ai, Xu, Ai, Xu, Ai, Xu, Ai, Xu, Ai, Xu, Rp, Xu, Rp, Xu, Rp, Xu, Rp, Xu, Rp, Xu, Ai, Xu, Ai, Xu, Ai, Xu, Ai, Xu, Ai, Xu, Rrc, Xu, Rrc, Xu, Rrc, Xu, Rrc, Xu, Rrc, Xu, Xu
Xu, Xu, Xu, Xu, Xu, Xu, Xu, Xu, Xu, Xu, Xu, Xu, Xu, Xu, Xu, Xu, Xu, Xu, Xu, Xu, Xu, Xu, Xu, Xu, Xu, Xu, Xu, Xu, Xu, Xu, Xu, Xu, Xu, Xu, Xu, Xu, Xu, Xu, Xu, Xu, Xu, Xu, Xu, Xu, Xu, Xu, Xu, Xu, Xu, Xu, Xu, Xu
Xu, Ai, Ai, Ai, Ai, Ai, Ai, Ai, Ai, Ai, Xu, Ai, Ai, Ai, Ai, Ai, Ai, Ai, Ai, Ai, Xu, Ai, Ai, Ai, Ai, Ai, Ai, Ai, Ai, Ai, Xu, Ai, Ai, Ai, Ai, Ai, Ai, Ai, Ai, Ai, Xu, Ai, Ai, Ai, Ai, Ai, Ai, Ai, Ai, Ai, Xu, Xu
Xu, Ai, Ai, Ai, Ai, Ai, Ai, Ai, Ai, Ai, Xu, Ai, Ai, Ai, Ai, Ai, Ai, Ai, Ai, Ai, Xu, Ai, Ai, Ai, Ai, Ai, Ai, Ai, Ai, Ai, Xu, Ai, Ai, Ai, Ai, Ai, Ai, Ai, Ai, Ai, Xu, Ai, Ai, Ai, Ai, Ai, Ai, Ai, Ai, Ai, Xu, Xu
Xu, Ai, Ai, Ai, Ai, Ai, Ai, Ai, Ai, Ai, Xu, Ai, Ai, Ai, Ai, Ai, Ai, Ai, Ai, Ai, Xu, Ai, Ai, Ai, Ai, Ai, Ai, Ai, Ai, Ai, Xu, Ai, Ai, Ai, Ai, Ai, Ai, Ai, Ai, Ai, Xu, Ai, Ai, Ai, Ai, Ai, Ai, Ai, Ai, Ai, Xu, Xu
Xu, Ai, Ai, Ai, Cud, Cud, Cud, Ai, Ai, Ai, Xu, Ai, Ai, Ai, Cud, Cud, Cud, Ai, Ai, Ai, Xu, Ai, Ai, Ai, Cud, Cud, Cud, Ai, Ai, Ai, Xu, Ai, Ai, Ai, Cud, Cud, Cud, Ai, Ai, Ai, Xu, Ai, Ai, Ai, Cud, Cud, Cud, Ai, Ai, Ai, Xu, Xu
Xu, Ai, Ai, Ai, Cud, Kud, Cud, Ai, Ai, Ai, Xu, Ai, Ai, Ai, Cud, Kud, Cud, Ai, Ai, Ai, Xu, Ai, Ai, Ai, Cud, Kud, Cud, Ai, Ai, Ai, Xu, Ai, Ai, Ai, Cud, Kud, Cud, Ai, Ai, Ai, Xu, Ai, Ai, Ai, Cud, Kud, Cud, Ai, Ai, Ai, Xu, Xu
Xu, Ai, Ai, Ai, Ai, Cud, Ai, Ai, Ai, Ai, Xu, Ai, Ai, Ai, Ai, Cud, Ai, Ai, Ai, Ai, Xu, Ai, Ai, Ai, Ai, Cud, Ai, Ai, Ai, Ai, Xu, Ai, Ai, Ai, Ai, Cud, Ai, Ai, Ai, Ai, Xu, Ai, Ai, Ai, Ai, Cud, Ai, Ai, Ai, Ai, Xu, Xu
Xu, Ai, Ai, Ai, Ai, Ai, Ai, Ai, Ai, Ai, Xu, Ai, Ai, Ai, Ai, Ai, Ai, Ai, Ai, Ai, Xu, Ai, Ai, Ai, Ai, Ai, Ai, Ai, Ai, Ai, Xu, Ai, Ai, Ai, Ai, Ai, Ai, Ai, Ai, Ai, Xu, Ai, Ai, Ai, Ai, Ai, Ai, Ai, Ai, Ai, Xu, Xu
Xu, Ai, Ai, Ai, Ai, Ai, Ai, Ai, Ai, Ai, Xu, Ai, Ai, Ai, Ai, Ai, Ai, Ai, Ai, Ai, Xu, Ai, Ai, Ai, Ai, Ai, Ai, Ai, Ai, Ai, Xu, Ai, Ai, Ai, Ai, Ai, Ai, Ai, Ai, Ai, Xu, Ai, Ai, Ai, Ai, Ai, Ai, Ai, Ai, Ai, Xu, Xu
Xu, Ai, Xu, Ai, Xu, Ai, Xu, Ai, Xu, Ai, Xu, Ai, Xu, Ai, Xu, Ai, Xu, Ai, Xu, Ai, Xu, Ai, Xu, Ai, Xu, Ai, Xu, Ai, Xu, Ai, Xu, Ai, Xu, Ai, Xu, Ai, Xu, Ai, Xu, Ai, Xu, Ai, Xu, Ai, Xu, Ai, Xu, Ai, Xu, Ai, Xu, Xu
Xu, Xu, Xu, Xu, Xu, Xu, Xu, Xu, Xu, Xu, Xu, Xu, Xu, Xu, Xu, Xu, Xu, Xu, Xu, Xu, Xu, Xu, Xu, Xu, Xu, Xu, Xu, Xu, Xu, Xu, Xu, Xu, Xu, Xu, Xu, Xu, Xu, Xu, Xu, Xu, Xu, Xu, Xu, Xu, Xu, Xu, Xu, Xu, Xu, Xu, Xu, Xu
Xu, Aa, Aa, Aa, Aa, Aa, Aa, Aa, Aa, Aa, Xu, Ai, Ai, Ai, Ai, Ai, Ai, Ai, Ai, Ai, Xu, Rrc, Rrc, Rrc, Rrc, Rrc, Rrc, Rrc, Rrc, Rrc, Xu, Ai, Ai, Ai, Ai, Ai, Ai, Ai, Ai, Ai, Xu, Aa, Aa, Aa, Aa, Aa, Aa, Aa, Aa, Aa, Xu, Xu
Xu, Aa, Aa, Aa, Aa, Aa, Aa, Aa, Aa, Aa, Xu, Ai, Ai, Ai, Ai, Ai, Ai, Ai, Ai, Ai, Xu, Rrc, Rrc, Rrc, Rrc, Rrc, Rrc, Rrc, Rrc, Rrc, Xu, Ai, Ai, Ai, Ai, Ai, Ai, Ai, Ai, Ai, Xu, Aa, Aa, Aa, Aa, Aa, Aa, Aa, Aa, Aa, Xu, Xu
Xu, Aa, Aa, Aa, Aa, Aa, Aa, Aa, Aa, Aa, Xu, Ai, Ai, Ai, Ai, Ai, Ai, Ai, Ai, Ai, Xu, Rrc, Rrc, Rrc, Rrc, Rrc, Rrc, Rrc, Rrc, Rrc, Xu, Ai, Ai, Ai, Ai, Ai, Ai, Ai, Ai, Ai, Xu, Aa, Aa, Aa, Aa, Aa, Aa, Aa, Aa, Aa, Xu, Xu
Xu, Aa, Aa, Aa, Cud, Cud, Cud, Aa, Aa, Aa, Xu, Ai, Ai, Ai, Cud, Cud, Cud, Ai, Ai, Ai, Xu, Rrc, Rrc, Rrc, Cud, Cud, Cud, Rrc, Rrc, Rrc, Xu, Ai, Ai, Ai, Cud, Cud, Cud, Ai, Ai, Ai, Xu, Aa, Aa, Aa, Cud, Cud, Cud, Aa, Aa, Aa, Xu, Xu
Xu, Aa, Aa, Aa, Cud, Kud, Cud, Aa, Aa, Aa, Xu, Ai, Ai, Ai, Cud, Kud, Cud, Ai, Ai, Ai, Xu, Rrc, Rrc, Rrc, Cud, Kud, Cud, Rrc, Rrc, Rrc, Xu, Ai, Ai, Ai, Cud, Kud, Cud, Ai, Ai, Ai, Xu, Aa, Aa, Aa, Cud, Kud, Cud, Aa, Aa, Aa, Xu, Xu
Xu, Aa, Aa, Aa, Aa, Cud, Aa, Aa, Aa, Aa, Xu, Ai, Ai, Ai, Ai, Cud, Ai, Ai, Ai, Ai, Xu, Rrc, Rrc, Rrc, Rrc, Cud, Rrc, Rrc, Rrc, Rrc, Xu, Ai, Ai, Ai, Ai, Cud, Ai, Ai, Ai, Ai, Xu, Aa, Aa, Aa, Aa, Cud, Aa, Aa, Aa, Aa, Xu, Xu
Xu, Aa, Aa, Aa, Aa, Aa, Aa, Aa, Aa, Aa, Xu, Ai, Ai, Ai, Ai, Ai, Ai, Ai, Ai, Ai, Xu, Rrc, Rrc, Rrc, Rrc, Rrc, Rrc, Rrc, Rrc, Rrc, Xu, Ai, Ai, Ai, Ai, Ai, Ai, Ai, Ai, Ai, Xu, Aa, Aa, Aa, Aa, Aa, Aa, Aa, Aa, Aa, Xu, Xu
Xu, Aa, Aa, Aa, Aa, Aa, Aa, Aa, Aa, Aa, Xu, Ai, Ai, Ai, Ai, Ai, Ai, Ai, Ai, Ai, Xu, Rrc, Rrc, Rrc, Rrc, Rrc, Rrc, Rrc, Rrc, Rrc, Xu, Ai, Ai, Ai, Ai, Ai, Ai, Ai, Ai, Ai, Xu, Aa, Aa, Aa, Aa, Aa, Aa, Aa, Aa, Aa, Xu, Xu
Xu, Aa, Xu, Aa, Xu, Aa, Xu, Aa, Xu, Aa, Xu, Ai, Xu, Ai, Xu, Ai, Xu, Ai, Xu, Ai, Xu, Rrc, Xu, Rrc, Xu, Rrc, Xu, Rrc, Xu, Rrc, Xu, Ai, Xu, Ai, Xu, Ai, Xu, Ai, Xu, Ai, Xu, Aa, Xu, Aa, Xu, Aa, Xu, Aa, Xu, Aa, Xu, Xu
Xu, Xu, Xu, Xu, Xu, Xu, Xu, Xu, Xu, Xu, Xu, Xu, Xu, Xu, Xu, Xu, Xu, Xu, Xu, Xu, Xu, Xu, Xu, Xu, Xu, Xu, Xu, Xu, Xu, Xu, Xu, Xu, Xu, Xu, Xu, Xu, Xu, Xu, Xu, Xu, Xu, Xu, Xu, Xu, Xu, Xu, Xu, Xu, Xu, Xu, Xu, Xu
Xu, Xu, Xu, Xu, Xu, Xu, Xu, Xu, Xu, Xu, Xu, Xu, Xu, Xu, Xu, Xu, Xu, Xu, Xu, Xu, Xu, Xu, Xu, Xu, Xu, Xu, Xu, Xu, Xu, Xu, Xu, Xu, Xu, Xu, Xu, Xu, Xu, Xu, Xu, Xu, Xu, Xu, Xu, Xu, Xu, Xu, Xu, Xu, Xu, Xu, Xu, Xu
