Xu, Xu, Xu, Xu, Xu, Xu, Xu, Xu, Xu, Xu, Xu, Xu, Xu, Xu, Xu, Xu, Xu, Xu, Xu, Xu, Xu, Xu, Xu, Xu, Xu, Xu, Xu, Xu, Xu, Xu, Xu, Xu, Xu, Xu, Xu, Xu, Xu, Xu, Xu, Xu, Xu, Xu, Xu, Xu, Xu, Xu, Xu, Xu, Xu, Xu, Xu, Xu
Xu, Aa, Aa, Aa, Aa, Aa, Aa, Aa, Aa, Aa, Xu, Ai, Ai, Ai, Ai, Ai, Ai, Ai, Ai, Ai, Xu, Rrc, Rrc, Rrc, Rrc, Rrc, Rrc, Rrc, Rrc, Rrc, Xu, Ai, Ai, Ai, Ai, Ai, Ai, Ai, Ai, Ai, Xu, Aa, Aa, Aa, Aa, Aa, Aa, Aa, Aa, Aa, Xu, Xu
Xu, Aa, Aa, Aa, Aa, Aa, Aa, Aa, Aa, Aa, Xu, Ai, Ai, Ai, Ai, Ai, Ai, Ai, Ai, Ai, Xu, Rrc, Rrc, Rrc, Rrc, Rrc, Rrc, Rrc, Rrc, Rrc, Xu, Ai, Ai, Ai, Ai, Ai, Ai, Ai, Ai, Ai, Xu, Aa, Aa, Aa, Aa, Aa, Aa, Aa, Aa, Aa, Xu, Xu
Xu, Aa, Aa, Aa, Aa, Aa, Aa, Aa, Aa, Aa, Xu, Ai, Ai, Ai, Ai, Ai, Ai, Ai, Ai, Ai, Xu, Rrc, Rrc, Rrc, Rrc, Rrc, Rrc, Rrc, Rrc, Rrc, Xu, Ai, Ai, Ai, Ai, Ai, Ai, Ai, Ai, Ai, Xu, Aa, Aa, Aa, Aa, Aa, Aa, Aa, Aa, Aa, Xu, Xu
Xu, Aa, Aa, Aa, Cud, Cud, Cud, Aa, Aa, Aa, Xu, Ai, Ai, Ai, Cud, Cud, Cud, Ai, Ai, Ai, Xu, Rrc, Rrc, Rrc, Cud, Cud, Cud, Rrc, Rrc, Rrc, Xu, Ai, Ai, Ai, Cud, Cud, Cud, Ai, Ai, Ai, Xu, Aa, Aa, Aa, Cud, Cud, Cud, Aa, Aa, Aa, Xu, Xu
Xu, Aa, Aa, Aa, Cud, 1_5_5 Kud, Cud, Aa, Aa, Aa, Xu, Ai, Ai, Ai, Cud, 2_15_5 Kud, Cud, Ai, Ai, Ai, Xu, Rrc, Rrc, Rrc, Cud, 3_25_5 Kud, Cud, Rrc, Rrc, Rrc, Xu, Ai, Ai, Ai, Cud, 4_35_5 Kud, Cud, Ai, Ai, Ai, Xu, Aa, Aa, Aa, Cud, 5_45_5 Kud, Cud, Aa, Aa, Aa, Xu, Xu
Xu, Aa, Aa, Aa, Aa, Cud, Aa, Aa, Aa, Aa, Xu, Ai, Ai, Ai, Ai, Cud, Ai, Ai, Ai, Ai, Xu, Rrc, Rrc, Rrc, Rrc, Cud, Rrc, Rrc, Rrc, Rrc, Xu, Ai, Ai, Ai, Ai, Cud, Ai, Ai, Ai, Ai, Xu, Aa, Aa, Aa, Aa, Cud, Aa, Aa, Aa, Aa, Xu, Xu
Xu, Aa, Aa, Aa, Aa, Aa, Aa, Aa, Aa, Aa, Xu, Ai, Ai, Ai, Ai, Ai, Ai, Ai, Ai, Ai, Xu, Rrc, Rrc, Rrc, Rrc, Rrc, Rrc, Rrc, Rrc, Rrc, Xu, Ai, Ai, Ai, Ai, Ai, Ai, Ai, Ai, Ai, Xu, Aa, Aa, Aa, Aa, Aa, Aa, Aa, Aa, Aa, Xu, Xu
Xu, Aa, Aa, Aa, Aa, Aa, Aa, Aa, Aa, Aa, Xu, Ai, Ai, Ai, Ai, Ai, Ai, Ai, Ai, Ai, Xu, Rrc, Rrc, Rrc, Rrc, Rrc, Rrc, Rrc, Rrc, Rrc, Xu, Ai, Ai, Ai, Ai, Ai, Ai, Ai, Ai, Ai, Xu, Aa, Aa, Aa, Aa, Aa, Aa, Aa, Aa, Aa, Xu, Xu
Xu, Aa, Xu, Aa, Xu, Aa, Xu, Aa, Xu, Aa, Xu, Ai, Xu, Ai, Xu, Ai, Xu, Ai, Xu, Ai, Xu, Rrc, Xu, Rrc, Xu, Rrc, Xu, Rrc, Xu, Rrc, Xu, Ai, Xu, Ai, Xu, Ai, Xu, Ai, Xu, Ai, Xu, Aa, Xu, Aa, Xu, Aa, Xu, Aa, Xu, Aa, Xu, Xu
Xu, Xu, Xu, Xu, Xu, Xu, Xu, Xu, Xu, Xu, Xu, Xu, Xu, Xu, Xu, Xu, Xu, Xu, Xu, Xu, Xu, Xu, Xu, Xu, Xu, Xu, Xu, Xu, Xu, Xu, Xu, Xu, Xu, Xu, Xu, Xu, Xu, Xu, Xu, Xu, Xu, Xu, Xu, Xu, Xu, Xu, Xu, Xu, Xu, Xu, Xu, Xu
Xu, Ai, Ai, Ai, Ai, Ai, Ai, Ai, Ai, Ai, Xu, Ai, Ai, Ai, Ai, Ai, Ai, Ai, Ai, Ai, Xu, Ai, Ai, Ai, Ai, Ai, Ai, Ai, Ai, Ai, Xu, Ai, Ai, Ai, Ai, Ai, Ai, Ai, Ai, Ai, Xu, Ai, Ai, Ai, Ai, Ai, Ai, Ai, Ai, Ai, Xu, Xu
Xu, Ai, Ai, Ai, Ai, Ai, Ai, Ai, Ai, Ai, Xu, Ai, Ai, Ai, Ai, Ai, Ai, Ai, Ai, Ai, Xu, Ai, Ai, Ai, Ai, Ai, Ai, Ai, Ai, Ai, Xu, Ai, Ai, Ai, Ai, Ai, Ai, Ai, Ai, Ai, Xu, Ai, Ai, Ai, Ai, Ai, Ai, Ai, Ai, Ai, Xu, Xu
Xu, Ai, Ai, Ai, Ai, Ai, Ai, Ai, Ai, Ai, Xu, Ai, Ai, Ai, Ai, Ai, Ai, Ai, Ai, Ai, Xu, Ai, Ai, Ai, Ai, Ai, Ai, Ai, Ai, Ai, Xu, Ai, Ai, Ai, Ai, Ai, Ai, Ai, Ai, Ai, Xu, Ai, Ai, Ai, Ai, Ai, Ai, Ai, Ai, Ai, Xu, Xu
Xu, Ai, Ai, Ai, Cud, Cud, Cud, Ai, Ai, Ai, Xu, Ai, Ai, Ai, Cud, Cud, Cud, Ai, Ai, Ai, Xu, Ai, Ai, Ai, Cud, Cud, Cud, Ai, Ai, Ai, Xu, Ai, Ai, Ai, Cud, Cud, Cud, Ai, Ai, Ai, Xu, Ai, Ai, Ai, Cud, Cud, Cud, Ai, Ai, Ai, Xu, Xu
Xu, Ai, Ai, Ai, Cud, 6_5_15 Kud, Cud, Ai, Ai, Ai, Xu, Ai, Ai, Ai, Cud, 7_15_15 Kud, Cud, Ai, Ai, Ai, Xu, Ai, Ai, Ai, Cud, 8_25_15 Kud, Cud, Ai, Ai, Ai, Xu, Ai, Ai, Ai, Cud, 9_35_15 Kud, Cud, Ai, Ai, Ai, Xu, Ai, Ai, Ai, Cud, 10_45_15 Kud, Cud, Ai, Ai, Ai, Xu, Xu
Xu, Ai, Ai, Ai, Ai, Cud, Ai, Ai, Ai, Ai, Xu, Ai, Ai, Ai, Ai, Cud, Ai, Ai, Ai, Ai, Xu, Ai, Ai, Ai, Ai, Cud, Ai, Ai, Ai, Ai, Xu, Ai, Ai, Ai, Ai, Cud, Ai, Ai, Ai, Ai, Xu, Ai, Ai, Ai, Ai, Cud, Ai, Ai, Ai, Ai, Xu, Xu
Xu, Ai, Ai, Ai, Ai, Ai, Ai, Ai, Ai, Ai, Xu, Ai, Ai, Ai, Ai, Ai, Ai, Ai, Ai, Ai, Xu, Ai, Ai, Ai, Ai, Ai, Ai, Ai, Ai, Ai, Xu, Ai, Ai, Ai, Ai, Ai, Ai, Ai, Ai, Ai, Xu, Ai, Ai, Ai, Ai, Ai, Ai, Ai, Ai, Ai, Xu, Xu
Xu, Ai, Ai, Ai, Ai, Ai, Ai, Ai, Ai, Ai, Xu, Ai, Ai, Ai, Ai, Ai, Ai, Ai, Ai, Ai, Xu, Ai, Ai, Ai, Ai, Ai, Ai, Ai, Ai, Ai, Xu, Ai, Ai, Ai, Ai, Ai, Ai, Ai, Ai, Ai, Xu, Ai, Ai, Ai, Ai, Ai, Ai, Ai, Ai, Ai, Xu, Xu
Xu, Ai, Xu, Ai, Xu, Ai, Xu, Ai, Xu, Ai, Xu, Ai, Xu, Ai, Xu, Ai, Xu, Ai, Xu, Ai, Xu, Ai, Xu, Ai, Xu, Ai, Xu, Ai, Xu, Ai, Xu, Ai, Xu, Ai, Xu, Ai, Xu, Ai, Xu, Ai, Xu, Ai, Xu, Ai, Xu, Ai, Xu, Ai, Xu, Ai, Xu, Xu
Xu, Xu, Xu, Xu, Xu, Xu, Xu, Xu, Xu, Xu, Xu, Xu, Xu, Xu, Xu, Xu, Xu, Xu, Xu, Xu, Xu, Xu, Xu, Xu, Xu, Xu, Xu, Xu, Xu, Xu, Xu, Xu, Xu, Xu, Xu, Xu, Xu, Xu, Xu, Xu, Xu, Xu, Xu, Xu, Xu, Xu, Xu, Xu, Xu, Xu, Xu, Xu
Xu, Rrc, Rrc, Rrc, Rrc, Rrc, Rrc, Rrc, Rrc, Rrc, Xu, Ai, Ai, Ai, Ai, Ai, Ai, Ai, Ai, Ai, Xu, Rp, Rp, Rp, Rp, Rp, Rp, Rp, Rp, Rp, Xu, Ai, Ai, Ai, Ai, Ai, Ai, Ai, Ai, Ai, Xu, Rrc, Rrc, Rrc, Rrc, Rrc, Rrc, Rrc, Rrc, Rrc, Xu, Xu
Xu, Rrc, Rrc, Rrc, Rrc, Rrc, Rrc, Rrc, Rrc, Rrc, Xu, Ai, Ai, Ai, Ai, Ai, Ai, Ai, Ai, Ai, Xu, Rp, Rp, Rp, Rp, Rp, Rp, Rp, Rp, Rp, Xu, Ai, Ai, Ai, Ai, Ai, Ai, Ai, Ai, Ai, Xu, Rrc, Rrc, Rrc, Rrc, Rrc, Rrc, Rrc, Rrc, Rrc, Xu, Xu
Xu, Rrc, Rrc, Rrc, Rrc, Rrc, Rrc, Rrc, Rrc, Rrc, Xu, Ai, Ai, Ai, Ai, Ai, Ai, Ai, Ai, Ai, Xu, Rp, Rp, Rp, Rp, Rp, Rp, Rp, Rp, Rp, Xu, Ai, Ai, Ai, Ai, Ai, Ai, Ai, Ai, Ai, Xu, Rrc, Rrc, Rrc, Rrc, Rrc, Rrc, Rrc, Rrc, Rrc, Xu, Xu
Xu, Rrc, Rrc, Rrc, Cud, Cud, Cud, Rrc, Rrc, Rrc, Xu, Ai, Ai, Ai, Cud, Cud, Cud, Ai, Ai, Ai, Xu, Rp, Rp, Rp, Cud, Cud, Cud, Rp, Rp, Rp, Xu, Ai, Ai, Ai, Cud, Cud, Cud, Ai, Ai, Ai, Xu, Rrc, Rrc, Rrc, Cud, Cud, Cud, Rrc, Rrc, Rrc, Xu, Xu
Xu, Rrc, Rrc, Rrc, Cud, 11_5_25 Kud, Cud, Rrc, Rrc, Rrc, Xu, Ai, Ai, Ai, Cud, 12_15_25 Kud, Cud, Ai, Ai, Ai, Xu, Rp, Rp, Rp, Cud, 13_25_25 Kud, Cud, Rp, Rp, Rp, Xu, Ai, Ai, Ai, Cud, 14_35_25 Kud, Cud, Ai, Ai, Ai, Xu, Rrc, Rrc, Rrc, Cud, 15_45_25 Kud, Cud, Rrc, Rrc, Rrc, Xu, Xu
Xu, Rrc, Rrc, Rrc, Rrc, Cud, Rrc, Rrc, Rrc, Rrc, Xu, Ai, Ai, Ai, Ai, Cud, Ai, Ai, Ai, Ai, Xu, Rp, Rp, Rp, Rp, Cud, Rp, Rp, Rp, Rp, Xu, Ai, Ai, Ai, Ai, Cud, Ai, Ai, Ai, Ai, Xu, Rrc, Rrc, Rrc, Rrc, Cud, Rrc, Rrc, Rrc, Rrc, Xu, Xu
Xu, Rrc, Rrc, Rrc, Rrc, Rrc, Rrc, Rrc, Rrc, Rrc, Xu, Ai, Ai, Ai, Ai, Ai, Ai, Ai, Ai, Ai, Xu, Rp, Rp, Rp, Rp, Rp, Rp, Rp, Rp, Rp, Xu, Ai, Ai, Ai, Ai, Ai, Ai, Ai, Ai, Ai, Xu, Rrc, Rrc, Rrc, Rrc, Rrc, Rrc, Rrc, Rrc, Rrc, Xu, Xu
Xu, Rrc, Rrc, Rrc, Rrc, Rrc, Rrc, Rrc, Rrc, Rrc, Xu, Ai, Ai, Ai, Ai, Ai, Ai, Ai, Ai, Ai, Xu, Rp, Rp, Rp, Rp, Rp, Rp, Rp, Rp, Rp, Xu, Ai, Ai, Ai, Ai, Ai, Ai, Ai, Ai, Ai, Xu, Rrc, Rrc, Rrc, Rrc, Rrc, Rrc, Rrc, Rrc, Rrc, Xu, Xu
Xu, Rrc, Xu, Rrc, Xu, Rrc, Xu, Rrc, Xu, Rrc, Xu, Ai, Xu, Ai, Xu, Ai, Xu, Ai, Xu, Ai, Xu, Rp, Xu, Rp, Xu, Rp, Xu, Rp, Xu, Rp, Xu, Ai, Xu, Ai, Xu, Ai, Xu, Ai, Xu, Ai, Xu, Rrc, Xu, Rrc, Xu, Rrc, Xu, Rrc, Xu, Rrc, Xu, Xu
Xu, Xu, Xu, Xu, Xu, Xu, Xu, Xu, Xu, Xu, Xu, Xu, Xu, Xu, Xu, Xu, Xu, Xu, Xu, Xu, Xu, Xu, Xu, Xu, Xu, Xu, Xu, Xu, Xu, Xu, Xu, Xu, Xu, Xu, Xu, Xu, Xu, Xu, Xu, Xu, Xu, Xu, Xu, Xu, Xu, Xu, Xu, Xu, Xu, Xu, Xu, Xu
Xu, Ai, Ai, Ai, Ai, Ai, Ai, Ai, Ai, Ai, Xu, Ai, Ai, Ai, Ai, Ai, Ai, Ai, Ai, Ai, Xu, Ai, Ai, Ai, Ai, Ai, Ai, Ai, Ai, Ai, Xu, Ai, Ai, Ai, Ai, Ai, Ai, Ai, Ai, Ai, Xu, Ai, Ai, Ai, Ai, Ai, Ai, Ai, Ai, Ai, Xu, Xu
Xu, Ai, Ai, Ai, Ai, Ai, Ai, Ai, Ai, Ai, Xu, Ai, Ai, Ai, Ai, Ai, Ai, Ai, Ai, Ai, Xu, Ai, Ai, Ai, Ai, Ai, Ai, Ai, Ai, Ai, Xu, Ai, Ai, Ai, Ai, Ai, Ai, Ai, Ai, Ai, Xu, Ai, Ai, Ai, Ai, Ai, Ai, Ai, Ai, Ai, Xu, Xu
Xu, Ai, Ai, Ai, Ai, Ai, Ai, Ai, Ai, Ai, Xu, Ai, Ai, Ai, Ai, Ai, Ai, Ai, Ai, Ai, Xu, Ai, Ai, Ai, Ai, Ai, Ai, Ai, Ai, Ai, Xu, Ai, Ai, Ai, Ai, Ai, Ai, Ai, Ai, Ai, Xu, Ai, Ai, Ai, Ai, Ai, Ai, Ai, Ai, Ai, Xu, Xu
Xu, Ai, Ai, Ai, Cud, Cud, Cud, Ai, Ai, Ai, Xu, Ai, Ai, Ai, Cud, Cud, Cud, Ai, Ai, Ai, Xu, Ai, Ai, Ai, Cud, Cud, Cud, Ai, Ai, Ai, Xu, Ai, Ai, Ai, Cud, Cud, Cud, Ai, Ai, Ai, Xu, Ai, Ai, Ai, Cud, Cud, Cud, Ai, Ai, Ai, Xu, Xu
Xu, Ai, Ai, Ai, Cud, 16_5_35 Kud, Cud, Ai, Ai, Ai, Xu, Ai, Ai, Ai, Cud, 17_15_35 Kud, Cud, Ai, Ai, Ai, Xu, Ai, Ai, Ai, Cud, 18_25_35 Kud, Cud, Ai, Ai, Ai, Xu, Ai, Ai, Ai, Cud, 19_35_35 Kud, Cud, Ai, Ai, Ai, Xu, Ai, Ai, Ai, Cud, 20_45_35 Kud, Cud, Ai, Ai, Ai, Xu, Xu
Xu, Ai, Ai, Ai, Ai, Cud, Ai, Ai, Ai, Ai, Xu, Ai, Ai, Ai, Ai, Cud, Ai, Ai, Ai, Ai, Xu, Ai, Ai, Ai, Ai, Cud, Ai, Ai, Ai, Ai, Xu, Ai, Ai, Ai, Ai, Cud, Ai, Ai, Ai, Ai, Xu, Ai, Ai, Ai, Ai, Cud, Ai, Ai, Ai, Ai, Xu, Xu
Xu, Ai, Ai, Ai, Ai, Ai, Ai, Ai, Ai, Ai, Xu, Ai, Ai, Ai, Ai, Ai, Ai, Ai, Ai, Ai, Xu, Ai, Ai, Ai, Ai, Ai, Ai, Ai, Ai, Ai, Xu, Ai, Ai, Ai, Ai, Ai, Ai, Ai, Ai, Ai, Xu, Ai, Ai, Ai, Ai, Ai, Ai, Ai, Ai, Ai, Xu, Xu
Xu, Ai, Ai, Ai, Ai, Ai, Ai, Ai, Ai, Ai, Xu, Ai, Ai, Ai, Ai, Ai, Ai, Ai, Ai, Ai, Xu, Ai, Ai, Ai, Ai, Ai, Ai, Ai, Ai, Ai, Xu, Ai, Ai, Ai, Ai, Ai, Ai, Ai, Ai, Ai, Xu, Ai, Ai, Ai, Ai, Ai, Ai, Ai, Ai, Ai, Xu, Xu
Xu, Ai, Xu, Ai, Xu, Ai, Xu, Ai, Xu, Ai, Xu, Ai, Xu, Ai, Xu, Ai, Xu, Ai, Xu, Ai, Xu, Ai, Xu, Ai, Xu, Ai, Xu, Ai, Xu, Ai, Xu, Ai, Xu, Ai, Xu, Ai, Xu, Ai, Xu, Ai, Xu, Ai, Xu, Ai, Xu, Ai, Xu, Ai, Xu, Ai, Xu, Xu
Xu, Xu, Xu, Xu, Xu, Xu, Xu, Xu, Xu, Xu, Xu, Xu, Xu, Xu, Xu, Xu, Xu, Xu, Xu, Xu, Xu, Xu, Xu, Xu, Xu, Xu, Xu, Xu, Xu, Xu, Xu, Xu, Xu, Xu, Xu, Xu, Xu, Xu, Xu, Xu, Xu, Xu, Xu, Xu, Xu, Xu, Xu, Xu, Xu, Xu, Xu, Xu
Xu, Aa, Aa, Aa, Aa, Aa, Aa, Aa, Aa, Aa, Xu, Ai, Ai, Ai, Ai, Ai, Ai, Ai, Ai, Ai, Xu, Rrc, Rrc, Rrc, Rrc, Rrc, Rrc, Rrc, Rrc, Rrc, Xu, Ai, Ai, Ai, Ai, Ai, Ai, Ai, Ai, Ai, Xu, Aa, Aa, Aa, Aa, Aa, Aa, Aa, Aa, Aa, Xu, Xu
Xu, Aa, Aa, Aa, Aa, Aa, Aa, Aa, Aa, Aa, Xu, Ai, Ai, Ai, Ai, Ai, Ai, Ai, Ai, Ai, Xu, Rrc, Rrc, Rrc, Rrc, Rrc, Rrc, Rrc, Rrc, Rrc, Xu, Ai, Ai, Ai, Ai, Ai, Ai, Ai, Ai, Ai, Xu, Aa, Aa, Aa, Aa, Aa, Aa, Aa, Aa, Aa, Xu, Xu
Xu, Aa, Aa, Aa, Aa, Aa, Aa, Aa, Aa, Aa, Xu, Ai, Ai, Ai, Ai, Ai, Ai, Ai, Ai, Ai, Xu, Rrc, Rrc, Rrc, Rrc, Rrc, Rrc, Rrc, Rrc, Rrc, Xu, Ai, Ai, Ai, Ai, Ai, Ai, Ai, Ai, Ai, Xu, Aa, Aa, Aa, Aa, Aa, Aa, Aa, Aa, Aa, Xu, Xu
Xu, Aa, Aa, Aa, Cud, Cud, Cud, Aa, Aa, Aa, Xu, Ai, Ai, Ai, Cud, Cud, Cud, Ai, Ai, Ai, Xu, Rrc, Rrc, Rrc, Cud, Cud, Cud, Rrc, Rrc, Rrc, Xu, Ai, Ai, Ai, Cud, Cud, Cud, Ai, Ai, Ai, Xu, Aa, Aa, Aa, Cud, Cud, Cud, Aa, Aa, Aa, Xu, Xu
Xu, Aa, Aa, Aa, Cud, 21_5_45 Kud, Cud, Aa, Aa, Aa, Xu, Ai, Ai, Ai, Cud, 22_15_45 Kud, Cud, Ai, Ai, Ai, Xu, Rrc, Rrc, Rrc, Cud, 23_25_45 Kud, Cud, Rrc, Rrc, Rrc, Xu, Ai, Ai, Ai, Cud, 24_35_45 Kud, Cud, Ai, Ai, Ai, Xu, Aa, Aa, Aa, Cud, 25_45_45 Kud, Cud, Aa, Aa, Aa, Xu, Xu
Xu, Aa, Aa, Aa, Aa, Cud, Aa, Aa, Aa, Aa, Xu, Ai, Ai, Ai, Ai, Cud, Ai, Ai, Ai, Ai, Xu, Rrc, Rrc, Rrc, Rrc, Cud, Rrc, Rrc, Rrc, Rrc, Xu, Ai, Ai, Ai, Ai, Cud, Ai, Ai, Ai, Ai, Xu, Aa, Aa, Aa, Aa, Cud, Aa, Aa, Aa, Aa, Xu, Xu
Xu, Aa, Aa, Aa, Aa, Aa, Aa, Aa, Aa, Aa, Xu, Ai, Ai, Ai, Ai, Ai, Ai, Ai, Ai, Ai, Xu, Rrc, Rrc, Rrc, Rrc, Rrc, Rrc, Rrc, Rrc, Rrc, Xu, Ai, Ai, Ai, Ai, Ai, Ai, Ai, Ai, Ai, Xu, Aa, Aa, Aa, Aa, Aa, Aa, Aa, Aa, Aa, Xu, Xu
Xu, Aa, Aa, Aa, Aa, Aa, Aa, Aa, Aa, Aa, Xu, Ai, Ai, Ai, Ai, Ai, Ai, Ai, Ai, Ai, Xu, Rrc, Rrc, Rrc, Rrc, Rrc, Rrc, Rrc, Rrc, Rrc, Xu, Ai, Ai, Ai, Ai, Ai, Ai, Ai, Ai, Ai, Xu, Aa, Aa, Aa, Aa, Aa, Aa, Aa, Aa, Aa, Xu, Xu
Xu, Aa, Xu, Aa, Xu, Aa, Xu, Aa, Xu, Aa, Xu, Ai, Xu, Ai, Xu, Ai, Xu, Ai, Xu, Ai, Xu, Rrc, Xu, Rrc, Xu, Rrc, Xu, Rrc, Xu, Rrc, Xu, Ai, Xu, Ai, Xu, Ai, Xu, Ai, Xu, Ai, Xu, Aa, Xu, Aa, Xu, Aa, Xu, Aa, Xu, Aa, Xu, Xu
Xu, Xu, Xu, Xu, Xu, Xu, Xu, Xu, Xu, Xu, Xu, Xu, Xu, Xu, Xu, Xu, Xu, Xu, Xu, Xu, Xu, Xu, Xu, Xu, Xu, Xu, Xu, Xu, Xu, Xu, Xu, Xu, Xu, Xu, Xu, Xu, Xu, Xu, Xu, Xu, Xu, Xu, Xu, Xu, Xu, Xu, Xu, Xu, Xu, Xu, Xu, Xu
Xu, Xu, Xu, Xu, Xu, Xu, Xu, Xu, Xu, Xu, Xu, Xu, Xu, Xu, Xu, Xu, Xu, Xu, Xu, Xu, Xu, Xu, Xu, Xu, Xu, Xu, Xu, Xu, Xu, Xu, Xu, Xu, Xu, Xu, Xu, Xu, Xu, Xu, Xu, Xu, Xu, Xu, Xu, Xu, Xu, Xu, Xu, Xu, Xu, Xu, Xu, Xu
