Xu, Xu, Xu, Xu, Xu, Xu, Xu, Xu, Xu, Xu, Xu, Xu, Xu, Xu, Xu, Xu, Xu, Xu, Xu, Xu, Xu, Xu, Xu, Xu, Xu, Xu, Xu, Xu, Xu, Xu, Xu, Xu, Xu, Xu, Xu, Xu, Xu, Xu, Xu, Xu, Xu, Xu, Xu, Xu, Xu, Xu, Xu, Xu, Xu, Xu, Xu, Xu, Xu, Xu, Xu, Xu, Xu, Xu, Xu, Xu, Xu, Xu, Xu, Xu, Xu, Xu, Xu, Xu, Xu, Xu, Xu, Xu
Xu, Ai, Ai, Ai, Ai, Ai, Ai, Ai, Ai, Ai, Xu, Ai, Ai, Ai, Ai, Ai, Ai, Ai, Ai, Ai, Xu, Ai, Ai, Ai, Ai, Ai, Ai, Ai, Ai, Ai, Xu, Ai, Ai, Ai, Ai, Ai, Ai, Ai, Ai, Ai, Xu, Ai, Ai, Ai, Ai, Ai, Ai, Ai, Ai, Ai, Xu, Ai, Ai, Ai, Ai, Ai, Ai, Ai, Ai, Ai, Xu, Ai, Ai, Ai, Ai, Ai, Ai, Ai, Ai, Ai, Xu, Xu
Xu, Ai, Ai, Ai, Ai, Ai, Ai, Ai, Ai, Ai, Xu, Ai, Ai, Ai, Ai, Ai, Ai, Ai, Ai, Ai, Xu, Ai, Ai, Ai, Ai, Ai, Ai, Ai, Ai, Ai, Xu, Ai, Ai, Ai, Ai, Ai, Ai, Ai, Ai, Ai, Xu, Ai, Ai, Ai, Ai, Ai, Ai, Ai, Ai, Ai, Xu, Ai, Ai, Ai, Ai, Ai, Ai, Ai, Ai, Ai, Xu, Ai, Ai, Ai, Ai, Ai, Ai, Ai, Ai, Ai, Xu, Xu
Xu, Ai, Ai, Ai, Ai, Ai, Ai, Ai, Ai, Ai, Xu, Ai, Ai, Ai, Ai, Ai, Ai, Ai, Ai, Ai, Xu, Ai, Ai, Ai, Ai, Ai, Ai, Ai, Ai, Ai, Xu, Ai, Ai, Ai, Ai, Ai, Ai, Ai, Ai, Ai, Xu, Ai, Ai, Ai, Ai, Ai, Ai, Ai, Ai, Ai, Xu, Ai, Ai, Ai, Ai, Ai, Ai, Ai, Ai, Ai, Xu, Ai, Ai, Ai, Ai, Ai, Ai, Ai, Ai, Ai, Xu, Xu
Xu, Ai, Ai, Ai, Cud, Cud, Cud, Ai, Ai, Ai, Xu, Ai, Ai, Ai, Cud, Cud, Cud, Ai, Ai, Ai, Xu, Ai, Ai, Ai, Cud, Cud, Cud, Ai, Ai, Ai, Xu, Ai, Ai, Ai, Cud, Cud, Cud, Ai, Ai, Ai, Xu, Ai, Ai, Ai, Cud, Cud, Cud, Ai, Ai, Ai, Xu, Ai, Ai, Ai, Cud, Cud, Cud, Ai, Ai, Ai, Xu, Ai, Ai, Ai, Cud, Cud, Cud, Ai, Ai, Ai, Xu, Xu
Xu, Ai, Ai, Ai, Cud, 1 Kud, Cud, Ai, Ai, Ai, Xu, Ai, Ai, Ai, Cud, 2 Kud, Cud, Ai, Ai, Ai, Xu, Ai, Ai, Ai, Cud, 3 Kud, Cud, Ai, Ai, Ai, Xu, Ai, Ai, Ai, Cud, 4 Kud, Cud, Ai, Ai, Ai, Xu, Ai, Ai, Ai, Cud, 5 Kud, Cud, Ai, Ai, Ai, Xu, Ai, Ai, Ai, Cud, 6 Kud, Cud, Ai, Ai, Ai, Xu, Ai, Ai, Ai, Cud, 7 Kud, Cud, Ai, Ai, Ai, Xu, Xu
Xu, Ai, Ai, Ai, Ai, Cud, Ai, Ai, Ai, Ai, Xu, Ai, Ai, Ai, Ai, Cud, Ai, Ai, Ai, Ai, Xu, Ai, Ai, Ai, Ai, Cud, Ai, Ai, Ai, Ai, Xu, Ai, Ai, Ai, Ai, Cud, Ai, Ai, Ai, Ai, Xu, Ai, Ai, Ai, Ai, Cud, Ai, Ai, Ai, Ai, Xu, Ai, Ai, Ai, Ai, Cud, Ai, Ai, Ai, Ai, Xu, Ai, Ai, Ai, Ai, Cud, Ai, Ai, Ai, Ai, Xu, Xu
Xu, Ai, Ai, Ai, Ai, Ai, Ai, Ai, Ai, Ai, Xu, Ai, Ai, Ai, Ai, Ai, Ai, Ai, Ai, Ai, Xu, Ai, Ai, Ai, Ai, Ai, Ai, Ai, Ai, Ai, Xu, Ai, Ai, Ai, Ai, Ai, Ai, Ai, Ai, Ai, Xu, Ai, Ai, Ai, Ai, Ai, Ai, Ai, Ai, Ai, Xu, Ai, Ai, Ai, Ai, Ai, Ai, Ai, Ai, Ai, Xu, Ai, Ai, Ai, Ai, Ai, Ai, Ai, Ai, Ai, Xu, Xu
Xu, Ai, Ai, Ai, Ai, Ai, Ai, Ai, Ai, Ai, Xu, Ai, Ai, Ai, Ai, Ai, Ai, Ai, Ai, Ai, Xu, Ai, Ai, Ai, Ai, Ai, Ai, Ai, Ai, Ai, Xu, Ai, Ai, Ai, Ai, Ai, Ai, Ai, Ai, Ai, Xu, Ai, Ai, Ai, Ai, Ai, Ai, Ai, Ai, Ai, Xu, Ai, Ai, Ai, Ai, Ai, Ai, Ai, Ai, Ai, Xu, Ai, Ai, Ai, Ai, Ai, Ai, Ai, Ai, Ai, Xu, Xu
Xu, Ai, Xu, Ai, Xu, Ai, Xu, Ai, Xu, Ai, Xu, Ai, Xu, Ai, Xu, Ai, Xu, Ai, Xu, Ai, Xu, Ai, Xu, Ai, Xu, Ai, Xu, Ai, Xu, Ai, Xu, Ai, Xu, Ai, Xu, Ai, Xu, Ai, Xu, Ai, Xu, Ai, Xu, Ai, Xu, Ai, Xu, Ai, Xu, Ai, Xu, Ai, Xu, Ai, Xu, Ai, Xu, Ai, Xu, Ai, Xu, Ai, Xu, Ai, Xu, Ai, Xu, Ai, Xu, Ai, Xu, Xu
Xu, Xu, Xu, Xu, Xu, Xu, Xu, Xu, Xu, Xu, Xu, Xu, Xu, Xu, Xu, Xu, Xu, Xu, Xu, Xu, Xu, Xu, Xu, Xu, Xu, Xu, Xu, Xu, Xu, Xu, Xu, Xu, Xu, Xu, Xu, Xu, Xu, Xu, Xu, Xu, Xu, Xu, Xu, Xu, Xu, Xu, Xu, Xu, Xu, Xu, Xu, Xu, Xu, Xu, Xu, Xu, Xu, Xu, Xu, Xu, Xu, Xu, Xu, Xu, Xu, Xu, Xu, Xu, Xu, Xu, Xu, Xu
Xu, Ai, Ai, Ai, Ai, Ai, Ai, Ai, Ai, Ai, Xu, Aa, Aa, Aa, Aa, Aa, Aa, Aa, Aa, Aa, Xu, Ai, Ai, Ai, Ai, Ai, Ai, Ai, Ai, Ai, Xu, Rrc, Rrc, Rrc, Rrc, Rrc, Rrc, Rrc, Rrc, Rrc, Xu, Ai, Ai, Ai, Ai, Ai, Ai, Ai, Ai, Ai, Xu, Aa, Aa, Aa, Aa, Aa, Aa, Aa, Aa, Aa, Xu, Ai, Ai, Ai, Ai, Ai, Ai, Ai, Ai, Ai, Xu, Xu
Xu, Ai, Ai, Ai, Ai, Ai, Ai, Ai, Ai, Ai, Xu, Aa, Aa, Aa, Aa, Aa, Aa, Aa, Aa, Aa, Xu, Ai, Ai, Ai, Ai, Ai, Ai, Ai, Ai, Ai, Xu, Rrc, Rrc, Rrc, Rrc, Rrc, Rrc, Rrc, Rrc, Rrc, Xu, Ai, Ai, Ai, Ai, Ai, Ai, Ai, Ai, Ai, Xu, Aa, Aa, Aa, Aa, Aa, Aa, Aa, Aa, Aa, Xu, Ai, Ai, Ai, Ai, Ai, Ai, Ai, Ai, Ai, Xu, Xu
Xu, Ai, Ai, Ai, Ai, Ai, Ai, Ai, Ai, Ai, Xu, Aa, Aa, Aa, Aa, Aa, Aa, Aa, Aa, Aa, Xu, Ai, Ai, Ai, Ai, Ai, Ai, Ai, Ai, Ai, Xu, Rrc, Rrc, Rrc, Rrc, Rrc, Rrc, Rrc, Rrc, Rrc, Xu, Ai, Ai, Ai, Ai, Ai, Ai, Ai, Ai, Ai, Xu, Aa, Aa, Aa, Aa, Aa, Aa, Aa, Aa, Aa, Xu, Ai, Ai, Ai, Ai, Ai, Ai, Ai, Ai, Ai, Xu, Xu
Xu, Ai, Ai, Ai, Cud, Cud, Cud, Ai, Ai, Ai, Xu, Aa, Aa, Aa, Cud, Cud, Cud, Aa, Aa, Aa, Xu, Ai, Ai, Ai, Cud, Cud, Cud, Ai, Ai, Ai, Xu, Rrc, Rrc, Rrc, Cud, Cud, Cud, Rrc, Rrc, Rrc, Xu, Ai, Ai, Ai, Cud, Cud, Cud, Ai, Ai, Ai, Xu, Aa, Aa, Aa, Cud, Cud, Cud, Aa, Aa, Aa, Xu, Ai, Ai, Ai, Cud, Cud, Cud, Ai, Ai, Ai, Xu, Xu
Xu, Ai, Ai, Ai, Cud, 8 Kud, Cud, Ai, Ai, Ai, Xu, Aa, Aa, Aa, Cud, 9 Kud, Cud, Aa, Aa, Aa, Xu, Ai, Ai, Ai, Cud, 10 Kud, Cud, Ai, Ai, Ai, Xu, Rrc, Rrc, Rrc, Cud, 11 Kud, Cud, Rrc, Rrc, Rrc, Xu, Ai, Ai, Ai, Cud, 12 Kud, Cud, Ai, Ai, Ai, Xu, Aa, Aa, Aa, Cud, 13 Kud, Cud, Aa, Aa, Aa, Xu, Ai, Ai, Ai, Cud, 14 Kud, Cud, Ai, Ai, Ai, Xu, Xu
Xu, Ai, Ai, Ai, Ai, Cud, Ai, Ai, Ai, Ai, Xu, Aa, Aa, Aa, Aa, Cud, Aa, Aa, Aa, Aa, Xu, Ai, Ai, Ai, Ai, Cud, Ai, Ai, Ai, Ai, Xu, Rrc, Rrc, Rrc, Rrc, Cud, Rrc, Rrc, Rrc, Rrc, Xu, Ai, Ai, Ai, Ai, Cud, Ai, Ai, Ai, Ai, Xu, Aa, Aa, Aa, Aa, Cud, Aa, Aa, Aa, Aa, Xu, Ai, Ai, Ai, Ai, Cud, Ai, Ai, Ai, Ai, Xu, Xu
Xu, Ai, Ai, Ai, Ai, Ai, Ai, Ai, Ai, Ai, Xu, Aa, Aa, Aa, Aa, Aa, Aa, Aa, Aa, Aa, Xu, Ai, Ai, Ai, Ai, Ai, Ai, Ai, Ai, Ai, Xu, Rrc, Rrc, Rrc, Rrc, Rrc, Rrc, Rrc, Rrc, Rrc, Xu, Ai, Ai, Ai, Ai, Ai, Ai, Ai, Ai, Ai, Xu, Aa, Aa, Aa, Aa, Aa, Aa, Aa, Aa, Aa, Xu, Ai, Ai, Ai, Ai, Ai, Ai, Ai, Ai, Ai, Xu, Xu
Xu, Ai, Ai, Ai, Ai, Ai, Ai, Ai, Ai, Ai, Xu, Aa, Aa, Aa, Aa, Aa, Aa, Aa, Aa, Aa, Xu, Ai, Ai, Ai, Ai, Ai, Ai, Ai, Ai, Ai, Xu, Rrc, Rrc, Rrc, Rrc, Rrc, Rrc, Rrc, Rrc, Rrc, Xu, Ai, Ai, Ai, Ai, Ai, Ai, Ai, Ai, Ai, Xu, Aa, Aa, Aa, Aa, Aa, Aa, Aa, Aa, Aa, Xu, Ai, Ai, Ai, Ai, Ai, Ai, Ai, Ai, Ai, Xu, Xu
Xu, Ai, Xu, Ai, Xu, Ai, Xu, Ai, Xu, Ai, Xu, Aa, Xu, Aa, Xu, Aa, Xu, Aa, Xu, Aa, Xu, Ai, Xu, Ai, Xu, Ai, Xu, Ai, Xu, Ai, Xu, Rrc, Xu, Rrc, Xu, Rrc, Xu, Rrc, Xu, Rrc, Xu, Ai, Xu, Ai, Xu, Ai, Xu, Ai, Xu, Ai, Xu, Aa, Xu, Aa, Xu, Aa, Xu, Aa, Xu, Aa, Xu, Ai, Xu, Ai, Xu, Ai, Xu, Ai, Xu, Ai, Xu, Xu
Xu, Xu, Xu, Xu, Xu, Xu, Xu, Xu, Xu, Xu, Xu, Xu, Xu, Xu, Xu, Xu, Xu, Xu, Xu, Xu, Xu, Xu, Xu, Xu, Xu, Xu, Xu, Xu, Xu, Xu, Xu, Xu, Xu, Xu, Xu, Xu, Xu, Xu, Xu, Xu, Xu, Xu, Xu, Xu, Xu, Xu, Xu, Xu, Xu, Xu, Xu, Xu, Xu, Xu, Xu, Xu, Xu, Xu, Xu, Xu, Xu, Xu, Xu, Xu, Xu, Xu, Xu, Xu, Xu, Xu, Xu, Xu
Xu, Ai, Ai, Ai, Ai, Ai, Ai, Ai, Ai, Ai, Xu, Ai, Ai, Ai, Ai, Ai, Ai, Ai, Ai, Ai, Xu, Ai, Ai, Ai, Ai, Ai, Ai, Ai, Ai, Ai, Xu, Ai, Ai, Ai, Ai, Ai, Ai, Ai, Ai, Ai, Xu, Ai, Ai, Ai, Ai, Ai, Ai, Ai, Ai, Ai, Xu, Ai, Ai, Ai, Ai, Ai, Ai, Ai, Ai, Ai, Xu, Ai, Ai, Ai, Ai, Ai, Ai, Ai, Ai, Ai, Xu, Xu
Xu, Ai, Ai, Ai, Ai, Ai, Ai, Ai, Ai, Ai, Xu, Ai, Ai, Ai, Ai, Ai, Ai, Ai, Ai, Ai, Xu, Ai, Ai, Ai, Ai, Ai, Ai, Ai, Ai, Ai, Xu, Ai, Ai, Ai, Ai, Ai, Ai, Ai, Ai, Ai, Xu, Ai, Ai, Ai, Ai, Ai, Ai, Ai, Ai, Ai, Xu, Ai, Ai, Ai, Ai, Ai, Ai, Ai, Ai, Ai, Xu, Ai, Ai, Ai, Ai, Ai, Ai, Ai, Ai, Ai, Xu, Xu
Xu, Ai, Ai, Ai, Ai, Ai, Ai, Ai, Ai, Ai, Xu, Ai, Ai, Ai, Ai, Ai, Ai, Ai, Ai, Ai, Xu, Ai, Ai, Ai, Ai, Ai, Ai, Ai, Ai, Ai, Xu, Ai, Ai, Ai, Ai, Ai, Ai, Ai, Ai, Ai, Xu, Ai, Ai, Ai, Ai, Ai, Ai, Ai, Ai, Ai, Xu, Ai, Ai, Ai, Ai, Ai, Ai, Ai, Ai, Ai, Xu, Ai, Ai, Ai, Ai, Ai, Ai, Ai, Ai, Ai, Xu, Xu
Xu, Ai, Ai, Ai, Cud, Cud, Cud, Ai, Ai, Ai, Xu, Ai, Ai, Ai, Cud, Cud, Cud, Ai, Ai, Ai, Xu, Ai, Ai, Ai, Cud, Cud, Cud, Ai, Ai, Ai, Xu, Ai, Ai, Ai, Cud, Cud, Cud, Ai, Ai, Ai, Xu, Ai, Ai, Ai, Cud, Cud, Cud, Ai, Ai, Ai, Xu, Ai, Ai, Ai, Cud, Cud, Cud, Ai, Ai, Ai, Xu, Ai, Ai, Ai, Cud, Cud, Cud, Ai, Ai, Ai, Xu, Xu
Xu, Ai, Ai, Ai, Cud, 15 Kud, Cud, Ai, Ai, Ai, Xu, Ai, Ai, Ai, Cud, 16 Kud, Cud, Ai, Ai, Ai, Xu, Ai, Ai, Ai, Cud, 17 Kud, Cud, Ai, Ai, Ai, Xu, Ai, Ai, Ai, Cud, 18 Kud, Cud, Ai, Ai, Ai, Xu, Ai, Ai, Ai, Cud, 19 Kud, Cud, Ai, Ai, Ai, Xu, Ai, Ai, Ai, Cud, 20 Kud, Cud, Ai, Ai, Ai, Xu, Ai, Ai, Ai, Cud, 21 Kud, Cud, Ai, Ai, Ai, Xu, Xu
Xu, Ai, Ai, Ai, Ai, Cud, Ai, Ai, Ai, Ai, Xu, Ai, Ai, Ai, Ai, Cud, Ai, Ai, Ai, Ai, Xu, Ai, Ai, Ai, Ai, Cud, Ai, Ai, Ai, Ai, Xu, Ai, Ai, Ai, Ai, Cud, Ai, Ai, Ai, Ai, Xu, Ai, Ai, Ai, Ai, Cud, Ai, Ai, Ai, Ai, Xu, Ai, Ai, Ai, Ai, Cud, Ai, Ai, Ai, Ai, Xu, Ai, Ai, Ai, Ai, Cud, Ai, Ai, Ai, Ai, Xu, Xu
Xu, Ai, Ai, Ai, Ai, Ai, Ai, Ai, Ai, Ai, Xu, Ai, Ai, Ai, Ai, Ai, Ai, Ai, Ai, Ai, Xu, Ai, Ai, Ai, Ai, Ai, Ai, Ai, Ai, Ai, Xu, Ai, Ai, Ai, Ai, Ai, Ai, Ai, Ai, Ai, Xu, Ai, Ai, Ai, Ai, Ai, Ai, Ai, Ai, Ai, Xu, Ai, Ai, Ai, Ai, Ai, Ai, Ai, Ai, Ai, Xu, Ai, Ai, Ai, Ai, Ai, Ai, Ai, Ai, Ai, Xu, Xu
Xu, Ai, Ai, Ai, Ai, Ai, Ai, Ai, Ai, Ai, Xu, Ai, Ai, Ai, Ai, Ai, Ai, Ai, Ai, Ai, Xu, Ai, Ai, Ai, Ai, Ai, Ai, Ai, Ai, Ai, Xu, Ai, Ai, Ai, Ai, Ai, Ai, Ai, Ai, Ai, Xu, Ai, Ai, Ai, Ai, Ai, Ai, Ai, Ai, Ai, Xu, Ai, Ai, Ai, Ai, Ai, Ai, Ai, Ai, Ai, Xu, Ai, Ai, Ai, Ai, Ai, Ai, Ai, Ai, Ai, Xu, Xu
Xu, Ai, Xu, Ai, Xu, Ai, Xu, Ai, Xu, Ai, Xu, Ai, Xu, Ai, Xu, Ai, Xu, Ai, Xu, Ai, Xu, Ai, Xu, Ai, Xu, Ai, Xu, Ai, Xu, Ai, Xu, Ai, Xu, Ai, Xu, Ai, Xu, Ai, Xu, Ai, Xu, Ai, Xu, Ai, Xu, Ai, Xu, Ai, Xu, Ai, Xu, Ai, Xu, Ai, Xu, Ai, Xu, Ai, Xu, Ai, Xu, Ai, Xu, Ai, Xu, Ai, Xu, Ai, Xu, Ai, Xu, Xu
Xu, Xu, Xu, Xu, Xu, Xu, Xu, Xu, Xu, Xu, Xu, Xu, Xu, Xu, Xu, Xu, Xu, Xu, Xu, Xu, Xu, Xu, Xu, Xu, Xu, Xu, Xu, Xu, Xu, Xu, Xu, Xu, Xu, Xu, Xu, Xu, Xu, Xu, Xu, Xu, Xu, Xu, Xu, Xu, Xu, Xu, Xu, Xu, Xu, Xu, Xu, Xu, Xu, Xu, Xu, Xu, Xu, Xu, Xu, Xu, Xu, Xu, Xu, Xu, Xu, Xu, Xu, Xu, Xu, Xu, Xu, Xu
Xu, Ai, Ai, Ai, Ai, Ai, Ai, Ai, Ai, Ai, Xu, Rrc, Rrc, Rrc, Rrc, Rrc, Rrc, Rrc, Rrc, Rrc, Xu, Ai, Ai, Ai, Ai, Ai, Ai, Ai, Ai, Ai, Xu, Rp, Rp, Rp, Rp, Rp, Rp, Rp, Rp, Rp, Xu, Ai, Ai, Ai, Ai, Ai, Ai, Ai, Ai, Ai, Xu, Rrc, Rrc, Rrc, Rrc, Rrc, Rrc, Rrc, Rrc, Rrc, Xu, Ai, Ai, Ai, Ai, Ai, Ai, Ai, Ai, Ai, Xu, Xu
Xu, Ai, Ai, Ai, Ai, Ai, Ai, Ai, Ai, Ai, Xu, Rrc, Rrc, Rrc, Rrc, Rrc, Rrc, Rrc, Rrc, Rrc, Xu, Ai, Ai, Ai, Ai, Ai, Ai, Ai, Ai, Ai, Xu, Rp, Rp, Rp, Rp, Rp, Rp, Rp, Rp, Rp, Xu, Ai, Ai, Ai, Ai, Ai, Ai, Ai, Ai, Ai, Xu, Rrc, Rrc, Rrc, Rrc, Rrc, Rrc, Rrc, Rrc, Rrc, Xu, Ai, Ai, Ai, Ai, Ai, Ai, Ai, Ai, Ai, Xu, Xu
Xu, Ai, Ai, Ai, Ai, Ai, Ai, Ai, Ai, Ai, Xu, Rrc, Rrc, Rrc, Rrc, Rrc, Rrc, Rrc, Rrc, Rrc, Xu, Ai, Ai, Ai, Ai, Ai, Ai, Ai, Ai, Ai, Xu, Rp, Rp, Rp, Rp, Rp, Rp, Rp, Rp, Rp, Xu, Ai, Ai, Ai, Ai, Ai, Ai, Ai, Ai, Ai, Xu, Rrc, Rrc, Rrc, Rrc, Rrc, Rrc, Rrc, Rrc, Rrc, Xu, Ai, Ai, Ai, Ai, Ai, Ai, Ai, Ai, Ai, Xu, Xu
Xu, Ai, Ai, Ai, Cud, Cud, Cud, Ai, Ai, Ai, Xu, Rrc, Rrc, Rrc, Cud, Cud, Cud, Rrc, Rrc, Rrc, Xu, Ai, Ai, Ai, Cud, Cud, Cud, Ai, Ai, Ai, Xu, Rp, Rp, Rp, Cud, Cud, Cud, Rp, Rp, Rp, Xu, Ai, Ai, Ai, Cud, Cud, Cud, Ai, Ai, Ai, Xu, Rrc, Rrc, Rrc, Cud, Cud, Cud, Rrc, Rrc, Rrc, Xu, Ai, Ai, Ai, Cud, Cud, Cud, Ai, Ai, Ai, Xu, Xu
Xu, Ai, Ai, Ai, Cud, 22 Kud, Cud, Ai, Ai, Ai, Xu, Rrc, Rrc, Rrc, Cud, 23 Kud, Cud, Rrc, Rrc, Rrc, Xu, Ai, Ai, Ai, Cud, 24 Kud, Cud, Ai, Ai, Ai, Xu, Rp, Rp, Rp, Cud, 25 Kud, Cud, Rp, Rp, Rp, Xu, Ai, Ai, Ai, Cud, 26 Kud, Cud, Ai, Ai, Ai, Xu, Rrc, Rrc, Rrc, Cud, 27 Kud, Cud, Rrc, Rrc, Rrc, Xu, Ai, Ai, Ai, Cud, 28 Kud, Cud, Ai, Ai, Ai, Xu, Xu
Xu, Ai, Ai, Ai, Ai, Cud, Ai, Ai, Ai, Ai, Xu, Rrc, Rrc, Rrc, Rrc, Cud, Rrc, Rrc, Rrc, Rrc, Xu, Ai, Ai, Ai, Ai, Cud, Ai, Ai, Ai, Ai, Xu, Rp, Rp, Rp, Rp, Cud, Rp, Rp, Rp, Rp, Xu, Ai, Ai, Ai, Ai, Cud, Ai, Ai, Ai, Ai, Xu, Rrc, Rrc, Rrc, Rrc, Cud, Rrc, Rrc, Rrc, Rrc, Xu, Ai, Ai, Ai, Ai, Cud, Ai, Ai, Ai, Ai, Xu, Xu
Xu, Ai, Ai, Ai, Ai, Ai, Ai, Ai, Ai, Ai, Xu, Rrc, Rrc, Rrc, Rrc, Rrc, Rrc, Rrc, Rrc, Rrc, Xu, Ai, Ai, Ai, Ai, Ai, Ai, Ai, Ai, Ai, Xu, Rp, Rp, Rp, Rp, Rp, Rp, Rp, Rp, Rp, Xu, Ai, Ai, Ai, Ai, Ai, Ai, Ai, Ai, Ai, Xu, Rrc, Rrc, Rrc, Rrc, Rrc, Rrc, Rrc, Rrc, Rrc, Xu, Ai, Ai, Ai, Ai, Ai, Ai, Ai, Ai, Ai, Xu, Xu
Xu, Ai, Ai, Ai, Ai, Ai, Ai, Ai, Ai, Ai, Xu, Rrc, Rrc, Rrc, Rrc, Rrc, Rrc, Rrc, Rrc, Rrc, Xu, Ai, Ai, Ai, Ai, Ai, Ai, Ai, Ai, Ai, Xu, Rp, Rp, Rp, Rp, Rp, Rp, Rp, Rp, Rp, Xu, Ai, Ai, Ai, Ai, Ai, Ai, Ai, Ai, Ai, Xu, Rrc, Rrc, Rrc, Rrc, Rrc, Rrc, Rrc, Rrc, Rrc, Xu, Ai, Ai, Ai, Ai, Ai, Ai, Ai, Ai, Ai, Xu, Xu
Xu, Ai, Xu, Ai, Xu, Ai, Xu, Ai, Xu, Ai, Xu, Rrc, Xu, Rrc, Xu, Rrc, Xu, Rrc, Xu, Rrc, Xu, Ai, Xu, Ai, Xu, Ai, Xu, Ai, Xu, Ai, Xu, Rp, Xu, Rp, Xu, Rp, Xu, Rp, Xu, Rp, Xu, Ai, Xu, Ai, Xu, Ai, Xu, Ai, Xu, Ai, Xu, Rrc, Xu, Rrc, Xu, Rrc, Xu, Rrc, Xu, Rrc, Xu, Ai, Xu, Ai, Xu, Ai, Xu, Ai, Xu, Ai, Xu, Xu
Xu, Xu, Xu, Xu, Xu, Xu, Xu, Xu, Xu, Xu, Xu, Xu, Xu, Xu, Xu, Xu, Xu, Xu, Xu, Xu, Xu, Xu, Xu, Xu, Xu, Xu, Xu, Xu, Xu, Xu, Xu, Xu, Xu, Xu, Xu, Xu, Xu, Xu, Xu, Xu, Xu, Xu, Xu, Xu, Xu, Xu, Xu, Xu, Xu, Xu, Xu, Xu, Xu, Xu, Xu, Xu, Xu, Xu, Xu, Xu, Xu, Xu, Xu, Xu, Xu, Xu, Xu, Xu, Xu, Xu, Xu, Xu
Xu, Ai, Ai, Ai, Ai, Ai, Ai, Ai, Ai, Ai, Xu, Ai, Ai, Ai, Ai, Ai, Ai, Ai, Ai, Ai, Xu, Ai, Ai, Ai, Ai, Ai, Ai, Ai, Ai, Ai, Xu, Ai, Ai, Ai, Ai, Ai, Ai, Ai, Ai, Ai, Xu, Ai, Ai, Ai, Ai, Ai, Ai, Ai, Ai, Ai, Xu, Ai, Ai, Ai, Ai, Ai, Ai, Ai, Ai, Ai, Xu, Ai, Ai, Ai, Ai, Ai, Ai, Ai, Ai, Ai, Xu, Xu
Xu, Ai, Ai, Ai, Ai, Ai, Ai, Ai, Ai, Ai, Xu, Ai, Ai, Ai, Ai, Ai, Ai, Ai, Ai, Ai, Xu, Ai, Ai, Ai, Ai, Ai, Ai, Ai, Ai, Ai, Xu, Ai, Ai, Ai, Ai, Ai, Ai, Ai, Ai, Ai, Xu, Ai, Ai, Ai, Ai, Ai, Ai, Ai, Ai, Ai, Xu, Ai, Ai, Ai, Ai, Ai, Ai, Ai, Ai, Ai, Xu, Ai, Ai, Ai, Ai, Ai, Ai, Ai, Ai, Ai, Xu, Xu
Xu, Ai, Ai, Ai, Ai, Ai, Ai, Ai, Ai, Ai, Xu, Ai, Ai, Ai, Ai, Ai, Ai, Ai, Ai, Ai, Xu, Ai, Ai, Ai, Ai, Ai, Ai, Ai, Ai, Ai, Xu, Ai, Ai, Ai, Ai, Ai, Ai, Ai, Ai, Ai, Xu, Ai, Ai, Ai, Ai, Ai, Ai, Ai, Ai, Ai, Xu, Ai, Ai, Ai, Ai, Ai, Ai, Ai, Ai, Ai, Xu, Ai, Ai, Ai, Ai, Ai, Ai, Ai, Ai, Ai, Xu, Xu
Xu, Ai, Ai, Ai, Cud, Cud, Cud, Ai, Ai, Ai, Xu, Ai, Ai, Ai, Cud, Cud, Cud, Ai, Ai, Ai, Xu, Ai, Ai, Ai, Cud, Cud, Cud, Ai, Ai, Ai, Xu, Ai, Ai, Ai, Cud, Cud, Cud, Ai, Ai, Ai, Xu, Ai, Ai, Ai, Cud, Cud, Cud, Ai, Ai, Ai, Xu, Ai, Ai, Ai, Cud, Cud, Cud, Ai, Ai, Ai, Xu, Ai, Ai, Ai, Cud, Cud, Cud, Ai, Ai, Ai, Xu, Xu
Xu, Ai, Ai, Ai, Cud, 29 Kud, Cud, Ai, Ai, Ai, Xu, Ai, Ai, Ai, Cud, 30 Kud, Cud, Ai, Ai, Ai, Xu, Ai, Ai, Ai, Cud, 31 Kud, Cud, Ai, Ai, Ai, Xu, Ai, Ai, Ai, Cud, 32 Kud, Cud, Ai, Ai, Ai, Xu, Ai, Ai, Ai, Cud, 33 Kud, Cud, Ai, Ai, Ai, Xu, Ai, Ai, Ai, Cud, 34 Kud, Cud, Ai, Ai, Ai, Xu, Ai, Ai, Ai, Cud, 35 Kud, Cud, Ai, Ai, Ai, Xu, Xu
Xu, Ai, Ai, Ai, Ai, Cud, Ai, Ai, Ai, Ai, Xu, Ai, Ai, Ai, Ai, Cud, Ai, Ai, Ai, Ai, Xu, Ai, Ai, Ai, Ai, Cud, Ai, Ai, Ai, Ai, Xu, Ai, Ai, Ai, Ai, Cud, Ai, Ai, Ai, Ai, Xu, Ai, Ai, Ai, Ai, Cud, Ai, Ai, Ai, Ai, Xu, Ai, Ai, Ai, Ai, Cud, Ai, Ai, Ai, Ai, Xu, Ai, Ai, Ai, Ai, Cud, Ai, Ai, Ai, Ai, Xu, Xu
Xu, Ai, Ai, Ai, Ai, Ai, Ai, Ai, Ai, Ai, Xu, Ai, Ai, Ai, Ai, Ai, Ai, Ai, Ai, Ai, Xu, Ai, Ai, Ai, Ai, Ai, Ai, Ai, Ai, Ai, Xu, Ai, Ai, Ai, Ai, Ai, Ai, Ai, Ai, Ai, Xu, Ai, Ai, Ai, Ai, Ai, Ai, Ai, Ai, Ai, Xu, Ai, Ai, Ai, Ai, Ai, Ai, Ai, Ai, Ai, Xu, Ai, Ai, Ai, Ai, Ai, Ai, Ai, Ai, Ai, Xu, Xu
Xu, Ai, Ai, Ai, Ai, Ai, Ai, Ai, Ai, Ai, Xu, Ai, Ai, Ai, Ai, Ai, Ai, Ai, Ai, Ai, Xu, Ai, Ai, Ai, Ai, Ai, Ai, Ai, Ai, Ai, Xu, Ai, Ai, Ai, Ai, Ai, Ai, Ai, Ai, Ai, Xu, Ai, Ai, Ai, Ai, Ai, Ai, Ai, Ai, Ai, Xu, Ai, Ai, Ai, Ai, Ai, Ai, Ai, Ai, Ai, Xu, Ai, Ai, Ai, Ai, Ai, Ai, Ai, Ai, Ai, Xu, Xu
Xu, Ai, Xu, Ai, Xu, Ai, Xu, Ai, Xu, Ai, Xu, Ai, Xu, Ai, Xu, Ai, Xu, Ai, Xu, Ai, Xu, Ai, Xu, Ai, Xu, Ai, Xu, Ai, Xu, Ai, Xu, Ai, Xu, Ai, Xu, Ai, Xu, Ai, Xu, Ai, Xu, Ai, Xu, Ai, Xu, Ai, Xu, Ai, Xu, Ai, Xu, Ai, Xu, Ai, Xu, Ai, Xu, Ai, Xu, Ai, Xu, Ai, Xu, Ai, Xu, Ai, Xu, Ai, Xu, Ai, Xu, Xu
Xu, Xu, Xu, Xu, Xu, Xu, Xu, Xu, Xu, Xu, Xu, Xu, Xu, Xu, Xu, Xu, Xu, Xu, Xu, Xu, Xu, Xu, Xu, Xu, Xu, Xu, Xu, Xu, Xu, Xu, Xu, Xu, Xu, Xu, Xu, Xu, Xu, Xu, Xu, Xu, Xu, Xu, Xu, Xu, Xu, Xu, Xu, Xu, Xu, Xu, Xu, Xu, Xu, Xu, Xu, Xu, Xu, Xu, Xu, Xu, Xu, Xu, Xu, Xu, Xu, Xu, Xu, Xu, Xu, Xu, Xu, Xu
Xu, Ai, Ai, Ai, Ai, Ai, Ai, Ai, Ai, Ai, Xu, Aa, Aa, Aa, Aa, Aa, Aa, Aa, Aa, Aa, Xu, Ai, Ai, Ai, Ai, Ai, Ai, Ai, Ai, Ai, Xu, Rrc, Rrc, Rrc, Rrc, Rrc, Rrc, Rrc, Rrc, Rrc, Xu, Ai, Ai, Ai, Ai, Ai, Ai, Ai, Ai, Ai, Xu, Aa, Aa, Aa, Aa, Aa, Aa, Aa, Aa, Aa, Xu, Ai, Ai, Ai, Ai, Ai, Ai, Ai, Ai, Ai, Xu, Xu
Xu, Ai, Ai, Ai, Ai, Ai, Ai, Ai, Ai, Ai, Xu, Aa, Aa, Aa, Aa, Aa, Aa, Aa, Aa, Aa, Xu, Ai, Ai, Ai, Ai, Ai, Ai, Ai, Ai, Ai, Xu, Rrc, Rrc, Rrc, Rrc, Rrc, Rrc, Rrc, Rrc, Rrc, Xu, Ai, Ai, Ai, Ai, Ai, Ai, Ai, Ai, Ai, Xu, Aa, Aa, Aa, Aa, Aa, Aa, Aa, Aa, Aa, Xu, Ai, Ai, Ai, Ai, Ai, Ai, Ai, Ai, Ai, Xu, Xu
Xu, Ai, Ai, Ai, Ai, Ai, Ai, Ai, Ai, Ai, Xu, Aa, Aa, Aa, Aa, Aa, Aa, Aa, Aa, Aa, Xu, Ai, Ai, Ai, Ai, Ai, Ai, Ai, Ai, Ai, Xu, Rrc, Rrc, Rrc, Rrc, Rrc, Rrc, Rrc, Rrc, Rrc, Xu, Ai, Ai, Ai, Ai, Ai, Ai, Ai, Ai, Ai, Xu, Aa, Aa, Aa, Aa, Aa, Aa, Aa, Aa, Aa, Xu, Ai, Ai, Ai, Ai, Ai, Ai, Ai, Ai, Ai, Xu, Xu
Xu, Ai, Ai, Ai, Cud, Cud, Cud, Ai, Ai, Ai, Xu, Aa, Aa, Aa, Cud, Cud, Cud, Aa, Aa, Aa, Xu, Ai, Ai, Ai, Cud, Cud, Cud, Ai, Ai, Ai, Xu, Rrc, Rrc, Rrc, Cud, Cud, Cud, Rrc, Rrc, Rrc, Xu, Ai, Ai, Ai, Cud, Cud, Cud, Ai, Ai, Ai, Xu, Aa, Aa, Aa, Cud, Cud, Cud, Aa, Aa, Aa, Xu, Ai, Ai, Ai, Cud, Cud, Cud, Ai, Ai, Ai, Xu, Xu
Xu, Ai, Ai, Ai, Cud, 36 Kud, Cud, Ai, Ai, Ai, Xu, Aa, Aa, Aa, Cud, 37 Kud, Cud, Aa, Aa, Aa, Xu, Ai, Ai, Ai, Cud, 38 Kud, Cud, Ai, Ai, Ai, Xu, Rrc, Rrc, Rrc, Cud, 39 Kud, Cud, Rrc, Rrc, Rrc, Xu, Ai, Ai, Ai, Cud, 40 Kud, Cud, Ai, Ai, Ai, Xu, Aa, Aa, Aa, Cud, 41 Kud, Cud, Aa, Aa, Aa, Xu, Ai, Ai, Ai, Cud, 42 Kud, Cud, Ai, Ai, Ai, Xu, Xu
Xu, Ai, Ai, Ai, Ai, Cud, Ai, Ai, Ai, Ai, Xu, Aa, Aa, Aa, Aa, Cud, Aa, Aa, Aa, Aa, Xu, Ai, Ai, Ai, Ai, Cud, Ai, Ai, Ai, Ai, Xu, Rrc, Rrc, Rrc, Rrc, Cud, Rrc, Rrc, Rrc, Rrc, Xu, Ai, Ai, Ai, Ai, Cud, Ai, Ai, Ai, Ai, Xu, Aa, Aa, Aa, Aa, Cud, Aa, Aa, Aa, Aa, Xu, Ai, Ai, Ai, Ai, Cud, Ai, Ai, Ai, Ai, Xu, Xu
Xu, Ai, Ai, Ai, Ai, Ai, Ai, Ai, Ai, Ai, Xu, Aa, Aa, Aa, Aa, Aa, Aa, Aa, Aa, Aa, Xu, Ai, Ai, Ai, Ai, Ai, Ai, Ai, Ai, Ai, Xu, Rrc, Rrc, Rrc, Rrc, Rrc, Rrc, Rrc, Rrc, Rrc, Xu, Ai, Ai, Ai, Ai, Ai, Ai, Ai, Ai, Ai, Xu, Aa, Aa, Aa, Aa, Aa, Aa, Aa, Aa, Aa, Xu, Ai, Ai, Ai, Ai, Ai, Ai, Ai, Ai, Ai, Xu, Xu
Xu, Ai, Ai, Ai, Ai, Ai, Ai, Ai, Ai, Ai, Xu, Aa, Aa, Aa, Aa, Aa, Aa, Aa, Aa, Aa, Xu, Ai, Ai, Ai, Ai, Ai, Ai, Ai, Ai, Ai, Xu, Rrc, Rrc, Rrc, Rrc, Rrc, Rrc, Rrc, Rrc, Rrc, Xu, Ai, Ai, Ai, Ai, Ai, Ai, Ai, Ai, Ai, Xu, Aa, Aa, Aa, Aa, Aa, Aa, Aa, Aa, Aa, Xu, Ai, Ai, Ai, Ai, Ai, Ai, Ai, Ai, Ai, Xu, Xu
Xu, Ai, Xu, Ai, Xu, Ai, Xu, Ai, Xu, Ai, Xu, Aa, Xu, Aa, Xu, Aa, Xu, Aa, Xu, Aa, Xu, Ai, Xu, Ai, Xu, Ai, Xu, Ai, Xu, Ai, Xu, Rrc, Xu, Rrc, Xu, Rrc, Xu, Rrc, Xu, Rrc, Xu, Ai, Xu, Ai, Xu, Ai, Xu, Ai, Xu, Ai, Xu, Aa, Xu, Aa, Xu, Aa, Xu, Aa, Xu, Aa, Xu, Ai, Xu, Ai, Xu, Ai, Xu, Ai, Xu, Ai, Xu, Xu
Xu, Xu, Xu, Xu, Xu, Xu, Xu, Xu, Xu, Xu, Xu, Xu, Xu, Xu, Xu, Xu, Xu, Xu, Xu, Xu, Xu, Xu, Xu, Xu, Xu, Xu, Xu, Xu, Xu, Xu, Xu, Xu, Xu, Xu, Xu, Xu, Xu, Xu, Xu, Xu, Xu, Xu, Xu, Xu, Xu, Xu, Xu, Xu, Xu, Xu, Xu, Xu, Xu, Xu, Xu, Xu, Xu, Xu, Xu, Xu, Xu, Xu, Xu, Xu, Xu, Xu, Xu, Xu, Xu, Xu, Xu, Xu
Xu, Ai, Ai, Ai, Ai, Ai, Ai, Ai, Ai, Ai, Xu, Ai, Ai, Ai, Ai, Ai, Ai, Ai, Ai, Ai, Xu, Ai, Ai, Ai, Ai, Ai, Ai, Ai, Ai, Ai, Xu, Ai, Ai, Ai, Ai, Ai, Ai, Ai, Ai, Ai, Xu, Ai, Ai, Ai, Ai, Ai, Ai, Ai, Ai, Ai, Xu, Ai, Ai, Ai, Ai, Ai, Ai, Ai, Ai, Ai, Xu, Ai, Ai, Ai, Ai, Ai, Ai, Ai, Ai, Ai, Xu, Xu
Xu, Ai, Ai, Ai, Ai, Ai, Ai, Ai, Ai, Ai, Xu, Ai, Ai, Ai, Ai, Ai, Ai, Ai, Ai, Ai, Xu, Ai, Ai, Ai, Ai, Ai, Ai, Ai, Ai, Ai, Xu, Ai, Ai, Ai, Ai, Ai, Ai, Ai, Ai, Ai, Xu, Ai, Ai, Ai, Ai, Ai, Ai, Ai, Ai, Ai, Xu, Ai, Ai, Ai, Ai, Ai, Ai, Ai, Ai, Ai, Xu, Ai, Ai, Ai, Ai, Ai, Ai, Ai, Ai, Ai, Xu, Xu
Xu, Ai, Ai, Ai, Ai, Ai, Ai, Ai, Ai, Ai, Xu, Ai, Ai, Ai, Ai, Ai, Ai, Ai, Ai, Ai, Xu, Ai, Ai, Ai, Ai, Ai, Ai, Ai, Ai, Ai, Xu, Ai, Ai, Ai, Ai, Ai, Ai, Ai, Ai, Ai, Xu, Ai, Ai, Ai, Ai, Ai, Ai, Ai, Ai, Ai, Xu, Ai, Ai, Ai, Ai, Ai, Ai, Ai, Ai, Ai, Xu, Ai, Ai, Ai, Ai, Ai, Ai, Ai, Ai, Ai, Xu, Xu
Xu, Ai, Ai, Ai, Cud, Cud, Cud, Ai, Ai, Ai, Xu, Ai, Ai, Ai, Cud, Cud, Cud, Ai, Ai, Ai, Xu, Ai, Ai, Ai, Cud, Cud, Cud, Ai, Ai, Ai, Xu, Ai, Ai, Ai, Cud, Cud, Cud, Ai, Ai, Ai, Xu, Ai, Ai, Ai, Cud, Cud, Cud, Ai, Ai, Ai, Xu, Ai, Ai, Ai, Cud, Cud, Cud, Ai, Ai, Ai, Xu, Ai, Ai, Ai, Cud, Cud, Cud, Ai, Ai, Ai, Xu, Xu
Xu, Ai, Ai, Ai, Cud, 43 Kud, Cud, Ai, Ai, Ai, Xu, Ai, Ai, Ai, Cud, 44 Kud, Cud, Ai, Ai, Ai, Xu, Ai, Ai, Ai, Cud, 45 Kud, Cud, Ai, Ai, Ai, Xu, Ai, Ai, Ai, Cud, 46 Kud, Cud, Ai, Ai, Ai, Xu, Ai, Ai, Ai, Cud, 47 Kud, Cud, Ai, Ai, Ai, Xu, Ai, Ai, Ai, Cud, 48 Kud, Cud, Ai, Ai, Ai, Xu, Ai, Ai, Ai, Cud, 49 Kud, Cud, Ai, Ai, Ai, Xu, Xu
Xu, Ai, Ai, Ai, Ai, Cud, Ai, Ai, Ai, Ai, Xu, Ai, Ai, Ai, Ai, Cud, Ai, Ai, Ai, Ai, Xu, Ai, Ai, Ai, Ai, Cud, Ai, Ai, Ai, Ai, Xu, Ai, Ai, Ai, Ai, Cud, Ai, Ai, Ai, Ai, Xu, Ai, Ai, Ai, Ai, Cud, Ai, Ai, Ai, Ai, Xu, Ai, Ai, Ai, Ai, Cud, Ai, Ai, Ai, Ai, Xu, Ai, Ai, Ai, Ai, Cud, Ai, Ai, Ai, Ai, Xu, Xu
Xu, Ai, Ai, Ai, Ai, Ai, Ai, Ai, Ai, Ai, Xu, Ai, Ai, Ai, Ai, Ai, Ai, Ai, Ai, Ai, Xu, Ai, Ai, Ai, Ai, Ai, Ai, Ai, Ai, Ai, Xu, Ai, Ai, Ai, Ai, Ai, Ai, Ai, Ai, Ai, Xu, Ai, Ai, Ai, Ai, Ai, Ai, Ai, Ai, Ai, Xu, Ai, Ai, Ai, Ai, Ai, Ai, Ai, Ai, Ai, Xu, Ai, Ai, Ai, Ai, Ai, Ai, Ai, Ai, Ai, Xu, Xu
Xu, Ai, Ai, Ai, Ai, Ai, Ai, Ai, Ai, Ai, Xu, Ai, Ai, Ai, Ai, Ai, Ai, Ai, Ai, Ai, Xu, Ai, Ai, Ai, Ai, Ai, Ai, Ai, Ai, Ai, Xu, Ai, Ai, Ai, Ai, Ai, Ai, Ai, Ai, Ai, Xu, Ai, Ai, Ai, Ai, Ai, Ai, Ai, Ai, Ai, Xu, Ai, Ai, Ai, Ai, Ai, Ai, Ai, Ai, Ai, Xu, Ai, Ai, Ai, Ai, Ai, Ai, Ai, Ai, Ai, Xu, Xu
Xu, Ai, Xu, Ai, Xu, Ai, Xu, Ai, Xu, Ai, Xu, Ai, Xu, Ai, Xu, Ai, Xu, Ai, Xu, Ai, Xu, Ai, Xu, Ai, Xu, Ai, Xu, Ai, Xu, Ai, Xu, Ai, Xu, Ai, Xu, Ai, Xu, Ai, Xu, Ai, Xu, Ai, Xu, Ai, Xu, Ai, Xu, Ai, Xu, Ai, Xu, Ai, Xu, Ai, Xu, Ai, Xu, Ai, Xu, Ai, Xu, Ai, Xu, Ai, Xu, Ai, Xu, Ai, Xu, Ai, Xu, Xu
Xu, Xu, Xu, Xu, Xu, Xu, Xu, Xu, Xu, Xu, Xu, Xu, Xu, Xu, Xu, Xu, Xu, Xu, Xu, Xu, Xu, Xu, Xu, Xu, Xu, Xu, Xu, Xu, Xu, Xu, Xu, Xu, Xu, Xu, Xu, Xu, Xu, Xu, Xu, Xu, Xu, Xu, Xu, Xu, Xu, Xu, Xu, Xu, Xu, Xu, Xu, Xu, Xu, Xu, Xu, Xu, Xu, Xu, Xu, Xu, Xu, Xu, Xu, Xu, Xu, Xu, Xu, Xu, Xu, Xu, Xu, Xu
Xu, Xu, Xu, Xu, Xu, Xu, Xu, Xu, Xu, Xu, Xu, Xu, Xu, Xu, Xu, Xu, Xu, Xu, Xu, Xu, Xu, Xu, Xu, Xu, Xu, Xu, Xu, Xu, Xu, Xu, Xu, Xu, Xu, Xu, Xu, Xu, Xu, Xu, Xu, Xu, Xu, Xu, Xu, Xu, Xu, Xu, Xu, Xu, Xu, Xu, Xu, Xu, Xu, Xu, Xu, Xu, Xu, Xu, Xu, Xu, Xu, Xu, Xu, Xu, Xu, Xu, Xu, Xu, Xu, Xu, Xu, Xu
