Gs^Fp, Gs^Fp, Gs^Fp, Hh, Hh, Mm, Mm, Mm, Mm, Mm, Hh, Gg, Gg, Gg, Gg, Gg, Gg, Gg, Gg, Gg, Gs^Fp, Gs^Fp, Gs^Fp, Ss, Ss, Ss, Gs^Fp, Gs^Fp, Gg, Gg, Gs^Fp, Gs^Fp, Gs^Fp, Gg, Gg, Gs^Fp, Gs^Fp, Gs^Fp, Gs^Fp, Gg
Ss, Gg, Gs^Fp, Gg, Hh, Mm, Mm, Mm, Mm, Mm, Hh, Gg, Gg, Gg, Gg, Gg, Gg, Gg, Gs^Fp, Gs^Fp, Gs^Fp, Ss, Gs^Fp, Gs^Fp, Ss, Gg, Gs^Fp, Gs^Fp, Gg, Gg, Gg, Gs^Fp, Gs^Fp, Gg, Gg, Gs^Fp, Gs^Fp, Gs^Fp, Gg^Ve, Gg
Gg, Gg, Gs^Fp, Gg, Gg, Mm, Mm, Mm, Mm, Mm, Hh, Gg, Gg, Gg, Gg, Gg, Gs^Fp, Gs^Fp, Gs^Fp, Gg, Gg, Ss, Ss, Ss, Gg, Gg, Gg, Gg, Gg, Gg, Gg, Gg, Gg, Gg, Gg, Gg, Gg, Gs^Fp, Gs^Fp, Gg
Gg, Gs^Fp, Gg, Gg, Gg, Hh, Mm, Mm, Mm, Mm, Hh, Gg, Gg, Gs^Fp, Gs^Fp, Gs^Fp, Gs^Fp, Gg, Gg, Gg, Gg, Gg, Gg, Gg, Gg, Gg, Gg, Gs^Fp, Gg, Gg, Gg, Gg, Ch, Gg, Gg, Gg, Gg, Gg, Gs^Fp, Gg
Gs^Fp, Gg, Gg, Gg, Ch, Hh, Hh, Hh, Mm, Mm, Hh, Gg, Gs^Fp, Gs^Fp, Gs^Fp, Gs^Fp, Gs^Fp, Gg, Gg, Gg, Gg, Gg, Gs^Fp, Gg^Vh, Gg, Gg, Gs^Fp, Gs^Fp, Gg, Gg, Gg, Ch, 5 Kh, Ch, Gg, Gg, Gg, Gg, Gg, Gg
Gg, Gg, Gg, Ch, 4 Kh, Ch, Gg, Gg, Gg, Hh, Gg, Gg, Gs^Fp, Gg, Gs^Fp, Gs^Fp, Gg^Ve, Gs^Fp, Gs^Fp, Gs^Fp, Gs^Fp, Gs^Fp, Gg, Gg, Gs^Fp, Gs^Fp, Gg, Gg, Gg, Gg, Gg, Ch, Ch, Ch, Gg, Gg, Gg, Gg, Gs^Fp, Gs^Fp
Gg, Gg, Gg, Ch, Ch, Ch, Gg, Gg, Gg, Gg, Gg, Gs^Fp, Gs^Fp, Gg, Gs^Fp, Gs^Fp, Gs^Fp, Gs^Fp, Gs^Fp, Hh, Gg, Hh, Hh, Gg, Gg, Gg, Gg, Gg, Gg, Gg, Rr, Rr, Gg, Gg, Gg, Gg, Gg, Gg, Gs^Fp, Gs^Fp
Gg, Gg, Gg, Rr, Gs^Fp, Gg, Gg, Gs^Fp, Gg, Gg, Gg, Gs^Fp, Gs^Fp, Gs^Fp, Gg, Gg, Gs^Fp, Gs^Fp, Gg, Gg, Hh, Hh, Hh, Hh, Aa^Vha, Gg, Gg, Gg, Gg, Gg^Vh, Rr, Gg, Gg, Gg, Gg, Gg, Gg, Gg, Gs^Fp, Gs^Fp
Gg, Gg, Gg, Rr, Gs^Fp, Gs^Fp, Gs^Fp, Gs^Fp, Gs^Fp, Gs^Fp, Gg^Ve, Gs^Fp, Gs^Fp, Gg, Gs^Fp, Gs^Fp, Gg, Gs^Fp, Gs^Fp, Hh, Hh, Mm, Mm, Mm, Hh, Aa, Gg, Gg, Rr, Rr, Gg, Gs^Fp, Gs^Fp, Gg, Gs^Fp, Gg, Gg, Gs^Fp, Gg^Ve, Gs^Fp
Gg, Gg, Gg, Rr, Gg, Gs^Fp, Gs^Fp, Gs^Fp, Gs^Fp, Gs^Fp, Gs^Fp, Gs^Fp, Gg, Gg, Gs^Fp, Gs^Fp, Gs^Fp, Gg, Gs^Fp, Gg, Hh, Hh, Hh, Hh, Ha, Aa, Gg, Rr, Gg^Vh, Gg, Gg, Gg, Gs^Fp, Ss, Ss, Gs^Fp, Gg, Gs^Fp, Gs^Fp, Gs^Fp
Aa, Gg, Gg, Rr, Rr, Gg, Gg, Gs^Fp, Gs^Fp, Gs^Fp, Gs^Fp, Gg, Gg, Gg, Gs^Fp, Gs^Fp, Gs^Fp, Gg, Gg, Gs^Fp, Gg, Hh, Aa, Hh, Aa, Gg, Rr, Rr, Gg, Gg, Gg, Gg, Gs^Fp, Gg, Ss, Gg, Gs^Fp, Gs^Fp, Gs^Fp, Gs^Fp
Aa, Aa, Aa, Gg, Rr, Gg^Vh, Gg, Gg, Gs^Fp, Gs^Fp, Gs^Fp, Gs^Fp, Gg, Gg, Gg, Gs^Fp, Gg^Ve, Gs^Fp, Gs^Fp, Gs^Fp, Gg, Gg, Aa, Aa, Gg, Gg, Rr, Gg, Gg, Ds, Ww, Ds, Gg, Gs^Fp, Gg, Gg, Gs^Fp, Gs^Fp, Gg, Gg
Aa, Aa, Aa, Gg, Rr, Gg, Gg, Gg, Gg, Gg, Gg, Gg, Gg, Gg, Gg, Gg, Gg, Gg, Gg, Gg, Gg, Gg, Gg, Gg, Gg, Rr, Gg, Gs^Fp, Gs^Fp, Ds, Ds, Ds, Ds, Gs^Fp, Gg, Gg, Gs^Fp, Gg, Gg, Hh
Ha, Ha, Ha, Gg, Rr, Gg, Gg, Gg, Gg, Gg, Gg, Gg, Gg, Gg, Gg, Gg, Gg, Gg, Gg, Gg, Gg, Gg, Gg, Gg, Rr, Rr, Gg, Gs^Fp, Gg^Ve, Gs^Fp, Ds, Gg, Gg, Gs^Fp, Gg, Gg, Gs^Fp, Gg, Gg, Hh
Hh, Hh, Hh, Gg, Gg, Rr, Rr, Gg^Vh, Gg, Gg, Gs^Fp, Gg, Gg, Gg, Gg, Gg, Gg, Gg, Gg, Gg, Gg, Gg, Gg, Gg, Rr, Gg, Gs^Fp, Gs^Fp, Gs^Fp, Gg, Gg, Gg, Gg, Gs^Fp, Gs^Fp, Gs^Fp, Gg, Gg, Gg, Hh
Hh, Hh, Hh, Gg, Gg, Gg, Rr, Gg, Gg, Ds, Ds, Gs^Fp, Gg, Gg, Gg, Gg, Gg, Gg, Hh, Gg, Gg, Gg, Gg, Gg, Rr, Gs^Fp, Gg, Gg, Gs^Fp, Gg, Gg, Gg, Gg, Gs^Fp, Gg, Gg, Gg, Gg, Gg, Gg
Hh, Hh, Hh, Gs^Fp, Gg, Gg, Rr, Gg, Gg, Ds, Ww, Gg^Vh, Gg, Gg, Aa, Aa, Ha, Ha, Ha, Gg, Hh, Gg, Gg^Vh, Rr, Gs^Fp, Gs^Fp, Gg, Gg, Gg, Gg, Gg, Gg, Gg, Gg, Gg, Gg, Gg, Gg, Gg, Gg
Hh, Hh, Gs^Fp, Gg, Gg, Gg, Rr, Gg, Gg, Ds, Wo, Ds, Gg, Gg, Aa, Aa, Mm, Mm, Mm, Hh, Hh, Hh, Rr, Rr, Gs^Fp, Gg, Gg, Gg, Gg, Gs^Fp, Gg, Gg, Gg, Gg, Gs^Fp, Gs^Fp, Gs^Fp, Gg, Gg, Gg
Gs^Fp, Gs^Fp, Gs^Fp, Gg, Gg, Gg, Rr, Gs^Fp, Gs^Fp, Ds, Ww, Ww, Ds, Gg, Aa, Ha, Hh, Mm, Mm, Hh, Hh, Hh, Rr, Gg, Gs^Fp, Gg, Gg, Gg, Gs^Fp, Gs^Fp, Gg, Gg, Gg, Gs^Fp, Gs^Fp, Gg^Ve, Gs^Fp, Gg, Gg, Gg
Gs^Fp, Gs^Fp, Gs^Fp, Gg, Gg, Gg, Rr, Gs^Fp, Gg^Ve, Gs^Fp, Ww, Ww, Ds, Gg, Aa, Aa, Hh, Hh, Hh, Mm, Hh, Gg, Rr, Gs^Fp, Gs^Fp, Gg, Gg, Gg^Ve, Gs^Fp, Gg, Gg, Gg, Gg, Gg, Gg, Gs^Fp, Gs^Fp, Gg, Gg, Gg
Gg, Gg^Ve, Gs^Fp, Gg, Gg, Gg, Rr, Gg, Gs^Fp, Gs^Fp, Ds, Wo, Ds, Gg, Gg, Aa, Aa, Hh, Hh, Hh, Gg, Gg, Rr, Gs^Fp, Gs^Fp, Gs^Fp, Gs^Fp, Gs^Fp, Gg, Gg, Gg, Gg, Gs^Fp, Gg, Gg, Gg, Gs^Fp, Gg, Gg, Gg
Gg, Gs^Fp, Gg, Gs^Fp, Gg, Gg, Gg, Rr, Gg, Gs^Fp, Ds, Ww, Ww, Gg^Vh, Gg, Gg, Gg, Aa, Gg, Gg, Gs^Fp, Gs^Fp, Rr, Gs^Fp, Gs^Fp, Gg, Gg, Gg, Gg, Gg, Gg, Gs^Fp, Gs^Fp, Gg, Hh, Hh, Gg, Gs^Fp, Gg, Gg
Gs^Fp, Gs^Fp, Gs^Fp, Gs^Fp, Hh, Gg, Rr, Rr, Gg, Gg, Ds, Ww, Ww, Ds, Gg, Gg, Gg, Gg, Gg, Gg, Rr, Rr, Gs^Fp, Gs^Fp, Gg^Ve, Gg, Gg, Gg, Gg, Gg, Gg, Gs^Fp, Gs^Fp, Gs^Fp, Hh, Hh, Gg, Gs^Fp, Gs^Fp, Gs^Fp
Gs^Fp, Gg, Gg, Hh, Gg, Gs^Fp, Rr, Gg, Gg, Gg, Gg, Ds, Ww, Ds, Ds, Gg, Gg, Gg, Rr, Rr, Gs^Fp, Ss, Ss, Gg, Gs^Fp, Gg, Gg, Gg, Gg, Gg, Gs^Fp, Gg, Gg, Gs^Fp, Gs^Fp, Hh, Gs^Fp, Gs^Fp, Gs^Fp, Gs^Fp
Gs^Fp, Gg, Gg, Hh, Gg, Gs^Fp, Rr, Gg, Gg, Gg, Gg, Ds, Wo, Ds, Ds, Ds, Gg, Gg^Vh, Rr, Ds, Ds, Ds, Gg, Gg, Gg, Gs^Fp, Gg, Gg, Gg, Gg, Gg, Gg, Gg, Gg, Gs^Fp, Gg^Ve, Gs^Fp, Gs^Fp, Gs^Fp, Gs^Fp
Gs^Fp, Gs^Fp, Gg, Hh, Gs^Fp, Gs^Fp, Rr, Gg, Gg, Gg, Ds, Ds, Ds, Ds, Gs^Fp, Gs^Fp, Rr, Rr, Ds, Wo, Ds, Gg, Gs^Fp, Gg, Gg, Gs^Fp, Gg, Gg, Gg, Gg, Gg, Gg, Gg, Gg, Gs^Fp, Gs^Fp, Gs^Fp, Gg, Gg, Gg
Gs^Fp, Gs^Fp, Gs^Fp, Gs^Fp, Gg^Ve, Gs^Fp, Rr, Gg, Gg, Ds, Ds, Ds, Ds, Gg, Gs^Fp, Rr, Gg^Vh, Gg, Gg, Ds, Ss, Gs^Fp, Gg, Gg, Gg, Gg, Gg, Gg^Vh, Gg, Gg, Gg, Gg, Gg, Gg, Gg, Gg, Gg, Gg, Gg, Gg
Gg, Gg, Gs^Fp, Gs^Fp, Gs^Fp, Gg, Rr, Gg, Gg, Ds, Ds, Gg, Gg, Gg, Rr, Rr, Gg, Gg, Gg, Gs^Fp, Gg, Gs^Fp, Gs^Fp, Gg, Gs^Fp, Gg, Gg, Gg, Gg, Gg, Gg, Gg, Gg, Gg, Gs^Fp, Gg, Gg, Gg, Gg, Gg
Gg, Gg, Gs^Fp, Gs^Fp, Gs^Fp, Gs^Fp, Rr, Gg, Gg, Ds, Rr, Rr, Rr, Rr, Gg, Gg, Gg, Gg, Gg, Gs^Fp, Gg, Gg, Gg, Gg^Ve, Gs^Fp, Gg, Gg, Gg, Gg, Gg, Gg, Gg, Gs^Fp, Gs^Fp, Gs^Fp, Gg, Gg, Gs^Fp, Gg, Gg
Gg, Gs^Fp, Gg, Gg, Gs^Fp, Gs^Fp, Rr, Gg, Rr, Rr, Gg, Gg^Vh, Gs^Fp, Gg, Gg, Gg, Gg, Gg, Gg, Gs^Fp, Gs^Fp, Gg, Hh, Gs^Fp, Gg, Gg, Gg, Gg, Gg, Gg, Gg, Gg, Gg^Ve, Gg, Gg, Gg, Gg, Gs^Fp, Gs^Fp, Gg
Gs^Fp, Gs^Fp, Gg, Gg, Rr, Rr, Gg, Gg, Rr, Gg, Gg, Gs^Fp, Gs^Fp, Gs^Fp, Gg, Gg, Gg, Gg, Gg, Gs^Fp, Gs^Fp, Hh, Hh, Gg, Gs^Fp, Gg, Gg, Gg, Gg, Gg, Gg, Gs^Fp, Gs^Fp, Gg, Gg, Gg, Gs^Fp, Gs^Fp, Gs^Fp, Gg
Gs^Fp, Gg, Gg, Gg, Rr, Gg^Vh, Rr, Rr, Gg, Gg, Gg, Gg, Gs^Fp, Gg, Gg, Gg, Gg, Gg, Gg, Gs^Fp, Hh, Hh, Hh, Gg, Gs^Fp, Gg, Gg, Gg, Rr, Rr, Rr, Gs^Fp, Gs^Fp, Gg, Gg, Gg, Gs^Fp, Gg, Gg, Gg
Gs^Fp, Gg, Gg, Gg, Ch, Rr, Gg, Gg, Gg, Gs^Fp, Gs^Fp, Gs^Fp, Gs^Fp, Gs^Fp, Gg, Gg, Gg, Gg, Gg, Hh, Hh, Gg, Gg, Gg, Gs^Fp, Gg, Rr, Rr, Gg, Gg, Gg, Rr, Rr, Gs^Fp, Ch, Gs^Fp, Gs^Fp, Gg, Gg, Gg
Gs^Fp, Gg, Gg, Ch, 1 Kh, Ch, Gg, Gs^Fp, Gg, Gg, Gs^Fp, Gg^Ve, Gs^Fp, Gg, Gg, Gg, Gg, Gg, Ch, Ch, Ch, Gs^Fp, Gs^Fp, Gs^Fp, Gs^Fp, Rr, Gg^Vh, Gg, Gg, Gg, Gg, Gs^Fp, Gs^Fp, Ch, 2 Kh, Ch, Gg, Gg, Gg, Gg
Gs^Fp, Gg, Gg, Ch, Ch, Ch, Gg, Gs^Fp, Gg, Ss, Gs^Fp, Gs^Fp, Gg, Gg, Gg, Gg, Gg, Gg, Ch, 3 Kh, Ch, Gg, Rr, Gg, Rr, Rr, Gg, Gg, Gg, Gg, Gs^Fp, Gg, Gs^Fp, Ch, Ch, Ch, Gg, Gg, Gg, Gg
Hh, Hh, Gg^Vh, Gg, Rr, Gg, Gg, Gs^Fp, Gg, Ss, Ss, Gs^Fp, Gg, Gg, Gg, Gg, Gg^Vh, Gg, Rr, Ch, Rr, Rr, Gg^Vh, Rr, Gg, Gg, Gg, Gg, Gg, Gs^Fp, Gg, Gg, Gg, Gg, Gs^Fp, Gs^Fp, Gg, Gg, Gg, Gg
Gg, Gs^Fp, Gg, Gg, Rr, Gg, Gg, Gg, Gs^Fp, Ss, Gs^Fp, Gs^Fp, Gg, Gg, Gg, Gg, Rr, Rr, Gg, Gg, Gg, Gg, Gg, Gg, Gg, Gg, Gg, Gg, Gg, Gs^Fp, Gg, Gg, Gg, Gg, Gg, Gs^Fp, Gg, Gg, Gg, Gg
Gg, Gg, Gg, Gg, Rr, Gg, Gg, Gg, Gs^Fp, Gs^Fp, Gs^Fp, Gs^Fp, Gg, Gg, Rr, Rr, Gg, Gg, Gg, Gg, Gg, Gg, Gg, Gg, Gg, Gg, Gg, Gg, Gg, Gg, Gs^Fp, Gs^Fp, Gs^Fp, Gs^Fp, Gg, Gs^Fp, Gg, Gg, Gg, Gs^Fp
Gg, Gg, Gg, Gg, Gg, Rr, Rr, Rr, Rr, Gs^Fp, Rr, Gs^Fp, Rr, Rr, Gg, Gg, Gg, Gg, Gg, Gg, Gg, Gg, Gg, Gg, Gg, Gg, Gg, Gg, Gg, Gg, Gs^Fp, Gs^Fp, Gs^Fp, Gs^Fp, Gs^Fp, Gg, Gs^Fp, Gg, Ds, Gg
Gg, Gg, Gg, Gg, Gg, Gg, Aa, Gg, Gg, Rr, Gs^Fp, Rr, Gg, Gg, Gg, Gg, Gg, Gg, Gs^Fp, Gs^Fp, Gs^Fp, Gg, Gg, Gg, Gg, Gg, Gg, Gg, Gg, Gg, Gg, Gs^Fp, Gs^Fp, Gs^Fp, Gs^Fp, Gs^Fp, Gs^Fp, Gg, Gg, Ds
